gRNA	31mer
ACCCCAGACACTCACTGCAC	CGCTCACCCCAGACACTCACTGCACCGGAGT
GACCATCATGTCCATGCTCG	AGCGCGACCATCATGTCCATGCTCGTGGTCT
TCGTGGTCTTTCTCTTGCTG	CATGCTCGTGGTCTTTCTCTTGCTGTGGGGT
CGTGGTCTTTCTCTTGCTGT	ATGCTCGTGGTCTTTCTCTTGCTGTGGGGTG
GTGGTCTTTCTCTTGCTGTG	TGCTCGTGGTCTTTCTCTTGCTGTGGGGTGA
CTTTCTCTTGCTGTGGGGTG	GTGGTCTTTCTCTTGCTGTGGGGTGAGGCCT
TGCTGTGGGGTGAGGCCTCC	TCTCTTGCTGTGGGGTGAGGCCTCCTGGGGT
GCTGTGGGGTGAGGCCTCCT	CTCTTGCTGTGGGGTGAGGCCTCCTGGGGTC
CTGTGGGGTGAGGCCTCCTG	TCTTGCTGTGGGGTGAGGCCTCCTGGGGTCT
GGGTGAGGCCTCCTGGGGTC	CTGTGGGGTGAGGCCTCCTGGGGTCTGGGTC
GGTGAGGCCTCCTGGGGTCT	TGTGGGGTGAGGCCTCCTGGGGTCTGGGTCC
CCTCCTGGGGTCTGGGTCCC	TGAGGCCTCCTGGGGTCTGGGTCCCTGGGGC
CTCCTGGGGTCTGGGTCCCT	GAGGCCTCCTGGGGTCTGGGTCCCTGGGGCG
TCCTGGGGTCTGGGTCCCTG	AGGCCTCCTGGGGTCTGGGTCCCTGGGGCGG
TGGGGTCTGGGTCCCTGGGG	CCTCCTGGGGTCTGGGTCCCTGGGGCGGGAG
GGGGTCTGGGTCCCTGGGGC	CTCCTGGGGTCTGGGTCCCTGGGGCGGGAGG
GTCTGGGTCCCTGGGGCGGG	CTGGGGTCTGGGTCCCTGGGGCGGGAGGGGG
TCTGGGTCCCTGGGGCGGGA	TGGGGTCTGGGTCCCTGGGGCGGGAGGGGGC
CTGGGTCCCTGGGGCGGGAG	GGGGTCTGGGTCCCTGGGGCGGGAGGGGGCG
TGGGTCCCTGGGGCGGGAGG	GGGTCTGGGTCCCTGGGGCGGGAGGGGGCGG
GTCCCTGGGGCGGGAGGGGG	TCTGGGTCCCTGGGGCGGGAGGGGGCGGGAA
TCCCTGGGGCGGGAGGGGGC	CTGGGTCCCTGGGGCGGGAGGGGGCGGGAAC
GGGCGGGAGGGGGCGGGAAC	CCCTGGGGCGGGAGGGGGCGGGAACAGGAGC
GGGCGGGAACAGGAGCCTTA	GGAGGGGGCGGGAACAGGAGCCTTACGGGGG
GGCGGGAACAGGAGCCTTAC	GAGGGGGCGGGAACAGGAGCCTTACGGGGGC
GCGGGAACAGGAGCCTTACG	AGGGGGCGGGAACAGGAGCCTTACGGGGGCT
CGGGAACAGGAGCCTTACGG	GGGGGCGGGAACAGGAGCCTTACGGGGGCTG
CTTACGGGGGCTGTCTCCGC	GGAGCCTTACGGGGGCTGTCTCCGCAGGTGT
CTGTCTCCGCAGGTGTCACC	GGGGGCTGTCTCCGCAGGTGTCACCTGGGGC
TGTCTCCGCAGGTGTCACCT	GGGGCTGTCTCCGCAGGTGTCACCTGGGGCC
GTCTCCGCAGGTGTCACCTG	GGGCTGTCTCCGCAGGTGTCACCTGGGGCCC
AAGCAGCCATATGTGAGTGC	GACAGAAGCAGCCATATGTGAGTGCAGGGGT
AGCAGCCATATGTGAGTGCA	ACAGAAGCAGCCATATGTGAGTGCAGGGGTG
GCAGCCATATGTGAGTGCAG	CAGAAGCAGCCATATGTGAGTGCAGGGGTGA
CATATGTGAGTGCAGGGGTG	GCAGCCATATGTGAGTGCAGGGGTGAGGTCT
GTGAGTGCAGGGGTGAGGTC	CATATGTGAGTGCAGGGGTGAGGTCTGGGAA
TGAGTGCAGGGGTGAGGTCT	ATATGTGAGTGCAGGGGTGAGGTCTGGGAAT
GCAGGGGTGAGGTCTGGGAA	TGAGTGCAGGGGTGAGGTCTGGGAATGGTGG
GGGGTGAGGTCTGGGAATGG	GTGCAGGGGTGAGGTCTGGGAATGGTGGGCC
GGGTGAGGTCTGGGAATGGT	TGCAGGGGTGAGGTCTGGGAATGGTGGGCCC
GGTCTGGGAATGGTGGGCCC	GGTGAGGTCTGGGAATGGTGGGCCCAGGCCG
TGGGAATGGTGGGCCCAGGC	AGGTCTGGGAATGGTGGGCCCAGGCCGGGGG
GGGAATGGTGGGCCCAGGCC	GGTCTGGGAATGGTGGGCCCAGGCCGGGGGG
GGAATGGTGGGCCCAGGCCG	GTCTGGGAATGGTGGGCCCAGGCCGGGGGGG
GAATGGTGGGCCCAGGCCGG	TCTGGGAATGGTGGGCCCAGGCCGGGGGGGA
AATGGTGGGCCCAGGCCGGG	CTGGGAATGGTGGGCCCAGGCCGGGGGGGAG
ATGGTGGGCCCAGGCCGGGG	TGGGAATGGTGGGCCCAGGCCGGGGGGGAGC
GGGGGGGAGCCCTGTCTCTG	AGGCCGGGGGGGAGCCCTGTCTCTGTGGCAC
ATGAGACGCAGCCCAGCCTG	AGTTTATGAGACGCAGCCCAGCCTGTGGGCA
TGAGACGCAGCCCAGCCTGT	GTTTATGAGACGCAGCCCAGCCTGTGGGCAG
CGAATCACTGCTGAAACCCT	GAGTCCGAATCACTGCTGAAACCCTTGGCCA
CAATGTGACGCTGACGTGCC	TTGGCCAATGTGACGCTGACGTGCCAGGCCC
GCTGACGTGCCAGGCCCACC	GTGACGCTGACGTGCCAGGCCCACCTGGAGA
GACTTCCAGCTGTTCAAGAA	CTCCAGACTTCCAGCTGTTCAAGAATGGGGT
ACTTCCAGCTGTTCAAGAAT	TCCAGACTTCCAGCTGTTCAAGAATGGGGTG
CTTCCAGCTGTTCAAGAATG	CCAGACTTCCAGCTGTTCAAGAATGGGGTGG
CCAGCTGTTCAAGAATGGGG	GACTTCCAGCTGTTCAAGAATGGGGTGGCCC
GTTCAAGAATGGGGTGGCCC	CAGCTGTTCAAGAATGGGGTGGCCCAGGAGC
CAAGCACCAGTTCCTGCTGA	GCCATCAAGCACCAGTTCCTGCTGACGGGTG
AAGCACCAGTTCCTGCTGAC	CCATCAAGCACCAGTTCCTGCTGACGGGTGA
CCTGCTGACGGGTGACACCC	CAGTTCCTGCTGACGGGTGACACCCAGGGCC
CTGCTGACGGGTGACACCCA	AGTTCCTGCTGACGGGTGACACCCAGGGCCG
GGGCCGCTACCGCTGCCGCT	ACCCAGGGCCGCTACCGCTGCCGCTCGGGCT
GGCCGCTACCGCTGCCGCTC	CCCAGGGCCGCTACCGCTGCCGCTCGGGCTT
TGCCGCTCGGGCTTGTCCAC	ACCGCTGCCGCTCGGGCTTGTCCACAGGATG
GCTCGGGCTTGTCCACAGGA	CTGCCGCTCGGGCTTGTCCACAGGATGGACC
GACCCAGCTGAGCAAGCTCC	GGATGGACCCAGCTGAGCAAGCTCCTGGAGC
AGCAAGCTCCTGGAGCTGAC	AGCTGAGCAAGCTCCTGGAGCTGACAGGGCC
GCAAGCTCCTGGAGCTGACA	GCTGAGCAAGCTCCTGGAGCTGACAGGGCCA
GCTGACAGGGCCAAGTGAGC	CTGGAGCTGACAGGGCCAAGTGAGCCGGGGC
CTGACAGGGCCAAGTGAGCC	TGGAGCTGACAGGGCCAAGTGAGCCGGGGCA
TGACAGGGCCAAGTGAGCCG	GGAGCTGACAGGGCCAAGTGAGCCGGGGCAT
AAGTGAGCCGGGGCATGAAT	GGGCCAAGTGAGCCGGGGCATGAATTGGGGG
AGTGAGCCGGGGCATGAATT	GGCCAAGTGAGCCGGGGCATGAATTGGGGGC
GTGAGCCGGGGCATGAATTG	GCCAAGTGAGCCGGGGCATGAATTGGGGGCC
TGAGCCGGGGCATGAATTGG	CCAAGTGAGCCGGGGCATGAATTGGGGGCCA
CGGGGCATGAATTGGGGGCC	TGAGCCGGGGCATGAATTGGGGGCCAGGAGG
GGCATGAATTGGGGGCCAGG	GCCGGGGCATGAATTGGGGGCCAGGAGGCAG
AATTGGGGGCCAGGAGGCAG	GCATGAATTGGGGGCCAGGAGGCAGTGGGTA
ATTGGGGGCCAGGAGGCAGT	CATGAATTGGGGGCCAGGAGGCAGTGGGTAG
GGGGCCAGGAGGCAGTGGGT	AATTGGGGGCCAGGAGGCAGTGGGTAGGTTG
GCAGTGGGTAGGTTGTTGAC	AGGAGGCAGTGGGTAGGTTGTTGACTGGGGG
CAGTGGGTAGGTTGTTGACT	GGAGGCAGTGGGTAGGTTGTTGACTGGGGGG
AGTGGGTAGGTTGTTGACTG	GAGGCAGTGGGTAGGTTGTTGACTGGGGGGT
GTGGGTAGGTTGTTGACTGG	AGGCAGTGGGTAGGTTGTTGACTGGGGGGTC
TGGGTAGGTTGTTGACTGGG	GGCAGTGGGTAGGTTGTTGACTGGGGGGTCT
CAATCTTCCCATCTGTCAAA	AGCCCCAATCTTCCCATCTGTCAAATGGGGA
AATCTTCCCATCTGTCAAAT	GCCCCAATCTTCCCATCTGTCAAATGGGGAT
ATCTTCCCATCTGTCAAATG	CCCCAATCTTCCCATCTGTCAAATGGGGATG
GGGATGATGTCTGTGTTGTA	AAATGGGGATGATGTCTGTGTTGTAAGGAAT
TCTGTGTTGTAAGGAATACA	TGATGTCTGTGTTGTAAGGAATACATGGTTG
TACATGGTTGTGTCCCCAGC	AGGAATACATGGTTGTGTCCCCAGCAGGCCC
GGTTGTGTCCCCAGCAGGCC	TACATGGTTGTGTCCCCAGCAGGCCCGGCAT
GCCGTATGCCTTGTTTCCAC	CTCTTGCCGTATGCCTTGTTTCCACTGGTGC
CCTTCACAGTCTTATGAGTG	TGTCTCCTTCACAGTCTTATGAGTGTGGGGC
CTTCACAGTCTTATGAGTGT	GTCTCCTTCACAGTCTTATGAGTGTGGGGCC
TTCACAGTCTTATGAGTGTG	TCTCCTTCACAGTCTTATGAGTGTGGGGCCC
GTCTTATGAGTGTGGGGCCC	TCACAGTCTTATGAGTGTGGGGCCCAGGTTC
GTGTGGGGCCCAGGTTCTGC	TATGAGTGTGGGGCCCAGGTTCTGCTGGGCT
TGTGGGGCCCAGGTTCTGCT	ATGAGTGTGGGGCCCAGGTTCTGCTGGGCTT
CAGAGTCCTTGCCTGCTCCC	ACCCACAGAGTCCTTGCCTGCTCCCTGGCTC
GCCTGCTCCCTGGCTCTCGA	TCCTTGCCTGCTCCCTGGCTCTCGATGGCGC
TCTCGATGGCGCCAGTGTCC	CTGGCTCTCGATGGCGCCAGTGTCCTGGATC
CCAGTGTCCTGGATCACCCC	TGGCGCCAGTGTCCTGGATCACCCCCGGCCT
AAAACAACAGCAGTGTGCCG	GCCTGAAAACAACAGCAGTGTGCCGAGGTGT
CAGTGTGCCGAGGTGTGCTG	AACAGCAGTGTGCCGAGGTGTGCTGCGGGGT
AGTGTGCCGAGGTGTGCTGC	ACAGCAGTGTGCCGAGGTGTGCTGCGGGGTG
GTGTGCCGAGGTGTGCTGCG	CAGCAGTGTGCCGAGGTGTGCTGCGGGGTGT
GGGGTGTGACTTTTCTGCTG	GCTGCGGGGTGTGACTTTTCTGCTGAGGCGG
GTGTGACTTTTCTGCTGAGG	GCGGGGTGTGACTTTTCTGCTGAGGCGGGAG
TGTGACTTTTCTGCTGAGGC	CGGGGTGTGACTTTTCTGCTGAGGCGGGAGG
GACTTTTCTGCTGAGGCGGG	GGTGTGACTTTTCTGCTGAGGCGGGAGGGCG
ACTTTTCTGCTGAGGCGGGA	GTGTGACTTTTCTGCTGAGGCGGGAGGGCGA
GGAGGGCGACCATGAGTTTC	AGGCGGGAGGGCGACCATGAGTTTCTGGAGG
GGGCGACCATGAGTTTCTGG	CGGGAGGGCGACCATGAGTTTCTGGAGGTGC
TGAGTTTCTGGAGGTGCCTG	GACCATGAGTTTCTGGAGGTGCCTGAGGCCC
TCTGGAGGTGCCTGAGGCCC	GAGTTTCTGGAGGTGCCTGAGGCCCAGGAGG
GGAGGTGCCTGAGGCCCAGG	TTTCTGGAGGTGCCTGAGGCCCAGGAGGATG
GCCTGAGGCCCAGGAGGATG	GAGGTGCCTGAGGCCCAGGAGGATGTGGAGG
TGAGGCCCAGGAGGATGTGG	GTGCCTGAGGCCCAGGAGGATGTGGAGGCCA
ACCTTTCCAGTCCATCAGCC	AGGCCACCTTTCCAGTCCATCAGCCTGGCAA
GCAACTACAGCTGCAGCTAC	GCCTGGCAACTACAGCTGCAGCTACCGGACC
AGCTGCAGCTACCGGACCGA	ACTACAGCTGCAGCTACCGGACCGATGGGGA
GCTGCAGCTACCGGACCGAT	CTACAGCTGCAGCTACCGGACCGATGGGGAA
CTGCAGCTACCGGACCGATG	TACAGCTGCAGCTACCGGACCGATGGGGAAG
AGCTACCGGACCGATGGGGA	GCTGCAGCTACCGGACCGATGGGGAAGGCGC
CAGCGCTACTGTGACCATTG	GAGCCCAGCGCTACTGTGACCATTGAGGAGC
ACTGTGACCATTGAGGAGCT	GCGCTACTGTGACCATTGAGGAGCTCGGTGA
ATTGAGGAGCTCGGTGACTG	TGACCATTGAGGAGCTCGGTGACTGTGGGAA
TTGAGGAGCTCGGTGACTGT	GACCATTGAGGAGCTCGGTGACTGTGGGAAC
GTGACTGTGGGAACCATCTC	GCTCGGTGACTGTGGGAACCATCTCTGGGGG
TGACTGTGGGAACCATCTCT	CTCGGTGACTGTGGGAACCATCTCTGGGGGC
GACTGTGGGAACCATCTCTG	TCGGTGACTGTGGGAACCATCTCTGGGGGCT
ACTGTGGGAACCATCTCTGG	CGGTGACTGTGGGAACCATCTCTGGGGGCTG
GAACCATCTCTGGGGGCTGC	TGTGGGAACCATCTCTGGGGGCTGCTGGGGG
AACCATCTCTGGGGGCTGCT	GTGGGAACCATCTCTGGGGGCTGCTGGGGGA
ACCATCTCTGGGGGCTGCTG	TGGGAACCATCTCTGGGGGCTGCTGGGGGAG
CCATCTCTGGGGGCTGCTGG	GGGAACCATCTCTGGGGGCTGCTGGGGGAGG
TCTCTGGGGGCTGCTGGGGG	AACCATCTCTGGGGGCTGCTGGGGGAGGAGG
CTGGGGGCTGCTGGGGGAGG	CATCTCTGGGGGCTGCTGGGGGAGGAGGATA
CTGCTGGGGGAGGAGGATAC	GGGGGCTGCTGGGGGAGGAGGATACAGGGGG
TGCTGGGGGAGGAGGATACA	GGGGCTGCTGGGGGAGGAGGATACAGGGGGC
GCTGGGGGAGGAGGATACAG	GGGCTGCTGGGGGAGGAGGATACAGGGGGCA
CTGGGGGAGGAGGATACAGG	GGCTGCTGGGGGAGGAGGATACAGGGGGCAT
CATGCTGAATGTCCTTGCCC	ACCTCCATGCTGAATGTCCTTGCCCAGGACC
GAATGTCCTTGCCCAGGACC	ATGCTGAATGTCCTTGCCCAGGACCAGGTCC
CCTTGCCCAGGACCAGGTCC	AATGTCCTTGCCCAGGACCAGGTCCAGGAAG
CAGGACCAGGTCCAGGAAGC	TTGCCCAGGACCAGGTCCAGGAAGCTGGCCA
GGTCCAGGAAGCTGGCCACA	GACCAGGTCCAGGAAGCTGGCCACACGGTTG
AAGCTGGCCACACGGTTGCC	CCAGGAAGCTGGCCACACGGTTGCCTGGGTC
AGCTGGCCACACGGTTGCCT	CAGGAAGCTGGCCACACGGTTGCCTGGGTCT
ACACGGTTGCCTGGGTCTGA	TGGCCACACGGTTGCCTGGGTCTGATGGTTG
CCTGGGTCTGATGGTTGCAA	GGTTGCCTGGGTCTGATGGTTGCAAAGGAGT
CTGATGGTTGCAAAGGAGTT	TGGGTCTGATGGTTGCAAAGGAGTTTGGGCA
TGATGGTTGCAAAGGAGTTT	GGGTCTGATGGTTGCAAAGGAGTTTGGGCAG
TTGCAAAGGAGTTTGGGCAG	GATGGTTGCAAAGGAGTTTGGGCAGAGGATG
GGCAGAGGATGCCCAAAGAA	GTTTGGGCAGAGGATGCCCAAAGAATGGAAG
GAGGATGCCCAAAGAATGGA	GGGCAGAGGATGCCCAAAGAATGGAAGGGTG
AGGATGCCCAAAGAATGGAA	GGCAGAGGATGCCCAAAGAATGGAAGGGTGA
GCCCAAAGAATGGAAGGGTG	AGGATGCCCAAAGAATGGAAGGGTGAGGCCG
AAAGAATGGAAGGGTGAGGC	TGCCCAAAGAATGGAAGGGTGAGGCCGGGTG
AAGAATGGAAGGGTGAGGCC	GCCCAAAGAATGGAAGGGTGAGGCCGGGTGC
TGGAAGGGTGAGGCCGGGTG	AAGAATGGAAGGGTGAGGCCGGGTGCGGTGG
AAGGGTGAGGCCGGGTGCGG	AATGGAAGGGTGAGGCCGGGTGCGGTGGCTC
CGCCTATAATCCCAGCACTT	GCTCACGCCTATAATCCCAGCACTTTGGGAG
GCCTATAATCCCAGCACTTT	CTCACGCCTATAATCCCAGCACTTTGGGAGG
TATAATCCCAGCACTTTGGG	ACGCCTATAATCCCAGCACTTTGGGAGGCTG
CCCAGCACTTTGGGAGGCTG	ATAATCCCAGCACTTTGGGAGGCTGAGGCCA
CTTTGGGAGGCTGAGGCCAG	CAGCACTTTGGGAGGCTGAGGCCAGCGGATC
GCTGAGGCCAGCGGATCATG	GGGAGGCTGAGGCCAGCGGATCATGAGGTCA
TAAAAATACAAAAATTAGCC	TCTACTAAAAATACAAAAATTAGCCAGGTGT
ATACAAAAATTAGCCAGGTG	TAAAAATACAAAAATTAGCCAGGTGTGGTGG
CAAAAATTAGCCAGGTGTGG	AAATACAAAAATTAGCCAGGTGTGGTGGCAG
AATTAGCCAGGTGTGGTGGC	ACAAAAATTAGCCAGGTGTGGTGGCAGGTGC
GCCTGTAGTACCAGCTACTC	CAGGTGCCTGTAGTACCAGCTACTCAGGAGG
TGTAGTACCAGCTACTCAGG	GTGCCTGTAGTACCAGCTACTCAGGAGGCTG
ACCAGCTACTCAGGAGGCTG	GTAGTACCAGCTACTCAGGAGGCTGAGGCAG
GCTACTCAGGAGGCTGAGGC	TACCAGCTACTCAGGAGGCTGAGGCAGGAGA
GCAGGAGAATCCCTTGAACC	CTGAGGCAGGAGAATCCCTTGAACCTGGGAG
CAGGAGAATCCCTTGAACCT	TGAGGCAGGAGAATCCCTTGAACCTGGGAGG
GAGAATCCCTTGAACCTGGG	GGCAGGAGAATCCCTTGAACCTGGGAGGCAG
AGAGCTTGCAGTGAGCTGAG	GAGGCAGAGCTTGCAGTGAGCTGAGTGGCGC
GGCGCCACTGCACTCCAGCC	TGAGTGGCGCCACTGCACTCCAGCCTGGGCA
GCGCCACTGCACTCCAGCCT	GAGTGGCGCCACTGCACTCCAGCCTGGGCAA
AAAAAAAAAAAAAAAAAGAA	TTTCAAAAAAAAAAAAAAAAAAGAATGGAAG
AAAAAAAAAAAAAGAATGGA	AAAAAAAAAAAAAAAAAAGAATGGAAGGGTG
AAAAAAAAAAAAGAATGGAA	AAAAAAAAAAAAAAAAAGAATGGAAGGGTGT
AAAGAATGGAAGGGTGTTCC	AAAAAAAAGAATGGAAGGGTGTTCCTGGGAT
AAGAATGGAAGGGTGTTCCT	AAAAAAAGAATGGAAGGGTGTTCCTGGGATT
GTGTTCCTGGGATTGCCACC	GAAGGGTGTTCCTGGGATTGCCACCCGGAGG
TTCCTGGGATTGCCACCCGG	GGGTGTTCCTGGGATTGCCACCCGGAGGGCA
TCCTGGGATTGCCACCCGGA	GGTGTTCCTGGGATTGCCACCCGGAGGGCAG
GATTGCCACCCGGAGGGCAG	CCTGGGATTGCCACCCGGAGGGCAGAGGTCT
CCACCCGGAGGGCAGAGGTC	GATTGCCACCCGGAGGGCAGAGGTCTGGGGA
CACCCGGAGGGCAGAGGTCT	ATTGCCACCCGGAGGGCAGAGGTCTGGGGAC
ACCCGGAGGGCAGAGGTCTG	TTGCCACCCGGAGGGCAGAGGTCTGGGGACT
GAGGGCAGAGGTCTGGGGAC	ACCCGGAGGGCAGAGGTCTGGGGACTGGGCA
AGGGCAGAGGTCTGGGGACT	CCCGGAGGGCAGAGGTCTGGGGACTGGGCAG
GAGGTCTGGGGACTGGGCAG	GGGCAGAGGTCTGGGGACTGGGCAGAGGGCA
AGGTCTGGGGACTGGGCAGA	GGCAGAGGTCTGGGGACTGGGCAGAGGGCAG
ACTGGGCAGAGGGCAGCTCC	TGGGGACTGGGCAGAGGGCAGCTCCAGGGAT
CTGGGCAGAGGGCAGCTCCA	GGGGACTGGGCAGAGGGCAGCTCCAGGGATG
GCAGAGGGCAGCTCCAGGGA	ACTGGGCAGAGGGCAGCTCCAGGGATGGGGC
CAGAGGGCAGCTCCAGGGAT	CTGGGCAGAGGGCAGCTCCAGGGATGGGGCA
AGAGGGCAGCTCCAGGGATG	TGGGCAGAGGGCAGCTCCAGGGATGGGGCAG
CCGCCTGTGCTGATGCACCA	CACCACCGCCTGTGCTGATGCACCATGGAGA
GCACCATGGAGAGTCCTCCC	CTGATGCACCATGGAGAGTCCTCCCAGGTCC
TCCTCCCAGGTCCTGCACCC	GAGAGTCCTCCCAGGTCCTGCACCCTGGCAA
GGTCCTGCACCCTGGCAACA	TCCCAGGTCCTGCACCCTGGCAACAAGGTGA
CAAGGTGACCCTCACCTGCG	GGCAACAAGGTGACCCTCACCTGCGTGGCTC
ACCTGCGTGGCTCCCCTGAG	CCCTCACCTGCGTGGCTCCCCTGAGTGGAGT
CGTGGCTCCCCTGAGTGGAG	ACCTGCGTGGCTCCCCTGAGTGGAGTGGACT
GTGGAGTGGACTTCCAGCTA	CCTGAGTGGAGTGGACTTCCAGCTACGGCGC
GTGGACTTCCAGCTACGGCG	GTGGAGTGGACTTCCAGCTACGGCGCGGGGA
TGGACTTCCAGCTACGGCGC	TGGAGTGGACTTCCAGCTACGGCGCGGGGAG
GGACTTCCAGCTACGGCGCG	GGAGTGGACTTCCAGCTACGGCGCGGGGAGA
GCGCGGGGAGAAAGAGCTGC	CTACGGCGCGGGGAGAAAGAGCTGCTGGTAC
AGAAAGAGCTGCTGGTACCC	CGGGGAGAAAGAGCTGCTGGTACCCAGGAGC
CATCTTCTTTCACCTGAACG	GATCGCATCTTCTTTCACCTGAACGCGGTGG
CTTCTTTCACCTGAACGCGG	CGCATCTTCTTTCACCTGAACGCGGTGGCCC
TCACCTGAACGCGGTGGCCC	TTCTTTCACCTGAACGCGGTGGCCCTGGGGG
CACCTGAACGCGGTGGCCCT	TCTTTCACCTGAACGCGGTGGCCCTGGGGGA
ACCTGAACGCGGTGGCCCTG	CTTTCACCTGAACGCGGTGGCCCTGGGGGAT
CCTGAACGCGGTGGCCCTGG	TTTCACCTGAACGCGGTGGCCCTGGGGGATG
AACGCGGTGGCCCTGGGGGA	ACCTGAACGCGGTGGCCCTGGGGGATGGAGG
GCGGTGGCCCTGGGGGATGG	TGAACGCGGTGGCCCTGGGGGATGGAGGTCA
GTCACTACACCTGCCGCTAC	TGGAGGTCACTACACCTGCCGCTACCGGCTG
CGGCTGCATGACAACCAAAA	GCTACCGGCTGCATGACAACCAAAACGGCTG
TGCATGACAACCAAAACGGC	CCGGCTGCATGACAACCAAAACGGCTGGTCC
GACAACCAAAACGGCTGGTC	TGCATGACAACCAAAACGGCTGGTCCGGGGA
ACAACCAAAACGGCTGGTCC	GCATGACAACCAAAACGGCTGGTCCGGGGAC
CAACCAAAACGGCTGGTCCG	CATGACAACCAAAACGGCTGGTCCGGGGACA
CTGGTCCGGGGACAGCGCGC	AACGGCTGGTCCGGGGACAGCGCGCCGGTCG
GTCGAGCTGATTCTGAGCGA	CGCCGGTCGAGCTGATTCTGAGCGATGGTGA
GATTCTGAGCGATGGTGAGC	GAGCTGATTCTGAGCGATGGTGAGCCGGGGC
ATTCTGAGCGATGGTGAGCC	AGCTGATTCTGAGCGATGGTGAGCCGGGGCC
TTCTGAGCGATGGTGAGCCG	GCTGATTCTGAGCGATGGTGAGCCGGGGCCA
GATGGTGAGCCGGGGCCAGC	TGAGCGATGGTGAGCCGGGGCCAGCAGGGAC
ATGGTGAGCCGGGGCCAGCA	GAGCGATGGTGAGCCGGGGCCAGCAGGGACA
GAGCCGGGGCCAGCAGGGAC	ATGGTGAGCCGGGGCCAGCAGGGACAGGGAC
AGCCGGGGCCAGCAGGGACA	TGGTGAGCCGGGGCCAGCAGGGACAGGGACG
GGCCAGCAGGGACAGGGACG	GCCGGGGCCAGCAGGGACAGGGACGCGGCTG
AGCAGGGACAGGGACGCGGC	GGGCCAGCAGGGACAGGGACGCGGCTGGGTC
GCAGGGACAGGGACGCGGCT	GGCCAGCAGGGACAGGGACGCGGCTGGGTCC
CAGGGACGCGGCTGGGTCCC	AGGGACAGGGACGCGGCTGGGTCCCTGGGGA
AGGGACGCGGCTGGGTCCCT	GGGACAGGGACGCGGCTGGGTCCCTGGGGAG
GGGACGCGGCTGGGTCCCTG	GGACAGGGACGCGGCTGGGTCCCTGGGGAGC
CGGCTGGGTCCCTGGGGAGC	GGACGCGGCTGGGTCCCTGGGGAGCAGGAGC
TGGGGAGCAGGAGCAGTACC	GTCCCTGGGGAGCAGGAGCAGTACCAGGTGT
GCAGTACCAGGTGTAGAGTC	CAGGAGCAGTACCAGGTGTAGAGTCTGGGGA
CAGTACCAGGTGTAGAGTCT	AGGAGCAGTACCAGGTGTAGAGTCTGGGGAA
AGTACCAGGTGTAGAGTCTG	GGAGCAGTACCAGGTGTAGAGTCTGGGGAAG
TCTGGGGAAGTGCAGTGCTC	TAGAGTCTGGGGAAGTGCAGTGCTCTGGGCC
CTGGGGAAGTGCAGTGCTCT	AGAGTCTGGGGAAGTGCAGTGCTCTGGGCCA
GAAGTGCAGTGCTCTGGGCC	CTGGGGAAGTGCAGTGCTCTGGGCCAGGGTC
AAGTGCAGTGCTCTGGGCCA	TGGGGAAGTGCAGTGCTCTGGGCCAGGGTCC
ATCCGCCCACCCGCCGATTC	ACTTTATCCGCCCACCCGCCGATTCAGGGTC
TCCGCCCACCCGCCGATTCA	CTTTATCCGCCCACCCGCCGATTCAGGGTCC
TGATGAGCGTGACAACCTTC	TATGATGATGAGCGTGACAACCTTCAGGCCC
TGACAACCTTCAGGCCCCAC	GAGCGTGACAACCTTCAGGCCCCACAGGGAA
GACAACCTTCAGGCCCCACA	AGCGTGACAACCTTCAGGCCCCACAGGGAAT
CAGGCCCCACAGGGAATAAC	ACCTTCAGGCCCCACAGGGAATAACTGGGTG
AGGCCCCACAGGGAATAACT	CCTTCAGGCCCCACAGGGAATAACTGGGTGA
CAGGGAATAACTGGGTGAAC	CCCCACAGGGAATAACTGGGTGAACAGGTCT
AATAACTGGGTGAACAGGTC	CAGGGAATAACTGGGTGAACAGGTCTGGCCC
TGGGTGAACAGGTCTGGCCC	ATAACTGGGTGAACAGGTCTGGCCCAGGCCA
ACAGGTCTGGCCCAGGCCAC	GGTGAACAGGTCTGGCCCAGGCCACAGGGGG
CAGGTCTGGCCCAGGCCACA	GTGAACAGGTCTGGCCCAGGCCACAGGGGGC
AGGTCTGGCCCAGGCCACAG	TGAACAGGTCTGGCCCAGGCCACAGGGGGCA
GGTCTGGCCCAGGCCACAGG	GAACAGGTCTGGCCCAGGCCACAGGGGGCAC
AGGCCACAGGGGGCACCACC	GGCCCAGGCCACAGGGGGCACCACCTGGCAG
CACAGGGGGCACCACCTGGC	CAGGCCACAGGGGGCACCACCTGGCAGGTCC
CAGGTCCCATCCCAGCTGCC	CCTGGCAGGTCCCATCCCAGCTGCCAGGTCT
CCATCCCAGCTGCCAGGTCT	AGGTCCCATCCCAGCTGCCAGGTCTAGGTGA
CCAGGTCTAGGTGAGCACTG	AGCTGCCAGGTCTAGGTGAGCACTGAGGGCC
CAGGTCTAGGTGAGCACTGA	GCTGCCAGGTCTAGGTGAGCACTGAGGGCCT
AGCACTGAGGGCCTCTGCTG	AGGTGAGCACTGAGGGCCTCTGCTGAGGCAG
GCTCCTCCGCTCGCTTGCCT	AGGCAGCTCCTCCGCTCGCTTGCCTTGGACC
CTCGCTTGCCTTGGACCTGA	CTCCGCTCGCTTGCCTTGGACCTGATGGTAT
ATTTAGCAAACTCTGAGCAC	ATGGTATTTAGCAAACTCTGAGCACCGGACA
ACAGCGAACCCCATGCCCAG	ACCGGACAGCGAACCCCATGCCCAGCGGACC
CCCCATGCCCAGCGGACCAC	GCGAACCCCATGCCCAGCGGACCACAGGGGC
CCCATGCCCAGCGGACCACA	CGAACCCCATGCCCAGCGGACCACAGGGGCC
CCATGCCCAGCGGACCACAG	GAACCCCATGCCCAGCGGACCACAGGGGCCC
GGACCACAGGGGCCCCTCCG	CCAGCGGACCACAGGGGCCCCTCCGTGGGGC
GACCACAGGGGCCCCTCCGT	CAGCGGACCACAGGGGCCCCTCCGTGGGGCG
ACCACAGGGGCCCCTCCGTG	AGCGGACCACAGGGGCCCCTCCGTGGGGCGG
ACAGGGGCCCCTCCGTGGGG	GGACCACAGGGGCCCCTCCGTGGGGCGGGCA
CAGGGGCCCCTCCGTGGGGC	GACCACAGGGGCCCCTCCGTGGGGCGGGCAT
CCCCTCCGTGGGGCGGGCAT	AGGGGCCCCTCCGTGGGGCGGGCATTGGGGC
CCCTCCGTGGGGCGGGCATT	GGGGCCCCTCCGTGGGGCGGGCATTGGGGCG
CCTCCGTGGGGCGGGCATTG	GGGCCCCTCCGTGGGGCGGGCATTGGGGCGG
CCGTGGGGCGGGCATTGGGG	CCCCTCCGTGGGGCGGGCATTGGGGCGGTGC
CGGTGCTCAGAAGACGCTCG	TGGGGCGGTGCTCAGAAGACGCTCGTGGAGC
GGAGCAAATCCACTACTGAG	CTCGTGGAGCAAATCCACTACTGAGCGGCAT
ACTGAGCGGCATCGTGCACC	CCACTACTGAGCGGCATCGTGCACCAGGCAT
AATTACTAAGAAACAGTGAA	AAACAAATTACTAAGAAACAGTGAAAGGGTG
ATTACTAAGAAACAGTGAAA	AACAAATTACTAAGAAACAGTGAAAGGGTGC
GGGTGCGTGTGAGATATCCA	TGAAAGGGTGCGTGTGAGATATCCAAGGACT
CGTGTGAGATATCCAAGGAC	GGGTGCGTGTGAGATATCCAAGGACTGGGAT
GTGTGAGATATCCAAGGACT	GGTGCGTGTGAGATATCCAAGGACTGGGATG
ATCCAAGGACTGGGATGCAA	GAGATATCCAAGGACTGGGATGCAAAGGTGG
CAAGGACTGGGATGCAAAGG	ATATCCAAGGACTGGGATGCAAAGGTGGGGC
AAGGACTGGGATGCAAAGGT	TATCCAAGGACTGGGATGCAAAGGTGGGGCG
AGGACTGGGATGCAAAGGTG	ATCCAAGGACTGGGATGCAAAGGTGGGGCGG
ACTGGGATGCAAAGGTGGGG	CAAGGACTGGGATGCAAAGGTGGGGCGGGCC
CTGGGATGCAAAGGTGGGGC	AAGGACTGGGATGCAAAGGTGGGGCGGGCCC
ATGCAAAGGTGGGGCGGGCC	CTGGGATGCAAAGGTGGGGCGGGCCCGGAGG
CAAAGGTGGGGCGGGCCCGG	GGATGCAAAGGTGGGGCGGGCCCGGAGGAGG
AGGTGGGGCGGGCCCGGAGG	TGCAAAGGTGGGGCGGGCCCGGAGGAGGCGA
GGGCGGGCCCGGAGGAGGCG	AGGTGGGGCGGGCCCGGAGGAGGCGAGGGAG
GGCGGGCCCGGAGGAGGCGA	GGTGGGGCGGGCCCGGAGGAGGCGAGGGAGG
GGGCCCGGAGGAGGCGAGGG	GGGGCGGGCCCGGAGGAGGCGAGGGAGGAAG
GAGGAGGCGAGGGAGGAAGC	GCCCGGAGGAGGCGAGGGAGGAAGCTGGCCA
GGCGAGGGAGGAAGCTGGCC	GAGGAGGCGAGGGAGGAAGCTGGCCAGGTCA
GGAAGCTGGCCAGGTCATTG	AGGGAGGAAGCTGGCCAGGTCATTGCGGGCA
GAAGCTGGCCAGGTCATTGC	GGGAGGAAGCTGGCCAGGTCATTGCGGGCAG
GCGGGCAGAAGACTCAGCCA	TCATTGCGGGCAGAAGACTCAGCCAAGGCAA
CAGCCAAGGCAAAGAGCGCG	AGACTCAGCCAAGGCAAAGAGCGCGAGGCCA
GCGAGGCCAGACCACGCGTT	AGAGCGCGAGGCCAGACCACGCGTTAGGGCC
CGAGGCCAGACCACGCGTTA	GAGCGCGAGGCCAGACCACGCGTTAGGGCCG
GTTAGGGCCGAGCCAGCCGC	CACGCGTTAGGGCCGAGCCAGCCGCTGGGCG
TTAGGGCCGAGCCAGCCGCT	ACGCGTTAGGGCCGAGCCAGCCGCTGGGCGC
CGAGCCAGCCGCTGGGCGCC	AGGGCCGAGCCAGCCGCTGGGCGCCCGGGTC
GAGCCAGCCGCTGGGCGCCC	GGGCCGAGCCAGCCGCTGGGCGCCCGGGTCA
CGCAGAGACGCTGCCCGCGC	TGCTCCGCAGAGACGCTGCCCGCGCCGGAGT
GCCCGCGCCGGAGTTCTCCC	ACGCTGCCCGCGCCGGAGTTCTCCCCGGAGC
GCCGGAGTTCTCCCCGGAGC	CCCGCGCCGGAGTTCTCCCCGGAGCCGGAGT
TTCTCCCCGGAGCCGGAGTC	CGGAGTTCTCCCCGGAGCCGGAGTCCGGCAG
CCCCGGAGCCGGAGTCCGGC	GTTCTCCCCGGAGCCGGAGTCCGGCAGGGCC
CCCGGAGCCGGAGTCCGGCA	TTCTCCCCGGAGCCGGAGTCCGGCAGGGCCT
CGGAGTCCGGCAGGGCCTTG	GGAGCCGGAGTCCGGCAGGGCCTTGCGGCTG
CCGGCAGGGCCTTGCGGCTG	GGAGTCCGGCAGGGCCTTGCGGCTGCGGTGC
GGCCTTGCGGCTGCGGTGCC	GGCAGGGCCTTGCGGCTGCGGTGCCTGGCGC
GCTGCGGTGCCTGGCGCCCC	TTGCGGCTGCGGTGCCTGGCGCCCCTGGAGG
GCGGTGCCTGGCGCCCCTGG	CGGCTGCGGTGCCTGGCGCCCCTGGAGGGCG
CGGTGCCTGGCGCCCCTGGA	GGCTGCGGTGCCTGGCGCCCCTGGAGGGCGC
GGAGGGCGCGCGCTTCGCCC	CCCCTGGAGGGCGCGCGCTTCGCCCTGGTGC
GCGCTTCGCCCTGGTGCGCG	GGCGCGCGCTTCGCCCTGGTGCGCGAGGACA
TCGCCCTGGTGCGCGAGGAC	GCGCTTCGCCCTGGTGCGCGAGGACAGGGGC
CGCCCTGGTGCGCGAGGACA	CGCTTCGCCCTGGTGCGCGAGGACAGGGGCG
GCCCTGGTGCGCGAGGACAG	GCTTCGCCCTGGTGCGCGAGGACAGGGGCGG
CTGGTGCGCGAGGACAGGGG	TCGCCCTGGTGCGCGAGGACAGGGGCGGGCG
TGGTGCGCGAGGACAGGGGC	CGCCCTGGTGCGCGAGGACAGGGGCGGGCGC
CACCGTTTCCAGAGCCCCGC	GCGTGCACCGTTTCCAGAGCCCCGCTGGGAC
ACCGTTTCCAGAGCCCCGCT	CGTGCACCGTTTCCAGAGCCCCGCTGGGACC
CCAGAGCCCCGCTGGGACCG	CGTTTCCAGAGCCCCGCTGGGACCGAGGCGC
CGAGCTGCACAACATTTCCG	CTCTTCGAGCTGCACAACATTTCCGTGGCTG
CAACTACAGCTGCGTCTACG	TCCGCCAACTACAGCTGCGTCTACGTGGACC
GTGGACCTGAAGCCGCCTTT	TCTACGTGGACCTGAAGCCGCCTTTCGGGGG
TGGACCTGAAGCCGCCTTTC	CTACGTGGACCTGAAGCCGCCTTTCGGGGGC
GGACCTGAAGCCGCCTTTCG	TACGTGGACCTGAAGCCGCCTTTCGGGGGCT
GACCTGAAGCCGCCTTTCGG	ACGTGGACCTGAAGCCGCCTTTCGGGGGCTC
CTCCGCGCCCAGCGAGCGCT	GGGGGCTCCGCGCCCAGCGAGCGCTTGGAGC
CGAGCGCTTGGAGCTGCACG	CCCAGCGAGCGCTTGGAGCTGCACGTGGACG
CGCTTGGAGCTGCACGTGGA	GCGAGCGCTTGGAGCTGCACGTGGACGGTGA
GCTGCACGTGGACGGTGAGC	TTGGAGCTGCACGTGGACGGTGAGCTGGCGG
GCACGTGGACGGTGAGCTGG	GAGCTGCACGTGGACGGTGAGCTGGCGGGGC
CACGTGGACGGTGAGCTGGC	AGCTGCACGTGGACGGTGAGCTGGCGGGGCA
ACGTGGACGGTGAGCTGGCG	GCTGCACGTGGACGGTGAGCTGGCGGGGCAC
GAGCTGGCGGGGCACCAGCG	ACGGTGAGCTGGCGGGGCACCAGCGAGGGCG
AGCTGGCGGGGCACCAGCGA	CGGTGAGCTGGCGGGGCACCAGCGAGGGCGG
TGGCGGGGCACCAGCGAGGG	TGAGCTGGCGGGGCACCAGCGAGGGCGGGCG
GGCGGGGCACCAGCGAGGGC	GAGCTGGCGGGGCACCAGCGAGGGCGGGCGC
GGCACCAGCGAGGGCGGGCG	GGCGGGGCACCAGCGAGGGCGGGCGCGGGTT
GCACCAGCGAGGGCGGGCGC	GCGGGGCACCAGCGAGGGCGGGCGCGGGTTC
GGCGCGGGTTCAGTGCCCCT	GGGCGGGCGCGGGTTCAGTGCCCCTCGGGGC
GCGCGGGTTCAGTGCCCCTC	GGCGGGCGCGGGTTCAGTGCCCCTCGGGGCC
CGCGGGTTCAGTGCCCCTCG	GCGGGCGCGGGTTCAGTGCCCCTCGGGGCCT
CTGTCTTTCCCCTCTTTCCT	GCCTCCTGTCTTTCCCCTCTTTCCTTGGGCG
TGTCTTTCCCCTCTTTCCTT	CCTCCTGTCTTTCCCCTCTTTCCTTGGGCGT
CTCTTTCCTTGGGCGTCCGA	TTCCCCTCTTTCCTTGGGCGTCCGACGGCGG
TTTCCTTGGGCGTCCGACGG	CCCTCTTTCCTTGGGCGTCCGACGGCGGCGC
GGCGTCCGACGGCGGCGCTC	CCTTGGGCGTCCGACGGCGGCGCTCTGGGCC
GCGTCCGACGGCGGCGCTCT	CTTGGGCGTCCGACGGCGGCGCTCTGGGCCT
GACGGCGGCGCTCTGGGCCT	CGTCCGACGGCGGCGCTCTGGGCCTTGGTTC
TCAGCCCCCATCGCCTACCC	TTGGTTCAGCCCCCATCGCCTACCCCGGCGG
GCCCCCATCGCCTACCCCGG	GTTCAGCCCCCATCGCCTACCCCGGCGGGGA
CCCCCATCGCCTACCCCGGC	TTCAGCCCCCATCGCCTACCCCGGCGGGGAG
CCCCATCGCCTACCCCGGCG	TCAGCCCCCATCGCCTACCCCGGCGGGGAGC
CGCCTACCCCGGCGGGGAGC	CCCATCGCCTACCCCGGCGGGGAGCAGGCGA
CCCGGCGGGGAGCAGGCGAT	CCTACCCCGGCGGGGAGCAGGCGATCGGTGG
GGCGGGGAGCAGGCGATCGG	ACCCCGGCGGGGAGCAGGCGATCGGTGGTCG
GAGCAGGCGATCGGTGGTCG	GCGGGGAGCAGGCGATCGGTGGTCGAGGGTC
AGCAGGCGATCGGTGGTCGA	CGGGGAGCAGGCGATCGGTGGTCGAGGGTCT
GCGATCGGTGGTCGAGGGTC	AGCAGGCGATCGGTGGTCGAGGGTCTGGGGA
CGATCGGTGGTCGAGGGTCT	GCAGGCGATCGGTGGTCGAGGGTCTGGGGAC
GATCGGTGGTCGAGGGTCTG	CAGGCGATCGGTGGTCGAGGGTCTGGGGACG
GTCGAGGGTCTGGGGACGCC	CGGTGGTCGAGGGTCTGGGGACGCCTGGAAT
TCTGGGGACGCCTGGAATTT	GAGGGTCTGGGGACGCCTGGAATTTCGGCTT
GAATTTCGGCTTATTTCCCA	GCCTGGAATTTCGGCTTATTTCCCACGGACG
TCCCACGGACGCAAGCCCGT	TTATTTCCCACGGACGCAAGCCCGTAGGTCA
CCCGTAGGTCACGTGTAGCG	GCAAGCCCGTAGGTCACGTGTAGCGTGGTGG
GTAGGTCACGTGTAGCGTGG	AGCCCGTAGGTCACGTGTAGCGTGGTGGTCG
GTCACGTGTAGCGTGGTGGT	CGTAGGTCACGTGTAGCGTGGTGGTCGGCAG
GTAGCGTGGTGGTCGGCAGC	CACGTGTAGCGTGGTGGTCGGCAGCAGGGAG
TAGCGTGGTGGTCGGCAGCA	ACGTGTAGCGTGGTGGTCGGCAGCAGGGAGG
CGTGGTGGTCGGCAGCAGGG	TGTAGCGTGGTGGTCGGCAGCAGGGAGGCTG
GTGGTCGGCAGCAGGGAGGC	GCGTGGTGGTCGGCAGCAGGGAGGCTGGCCC
GCAGCAGGGAGGCTGGCCCC	GGTCGGCAGCAGGGAGGCTGGCCCCAGGTTT
TTCAGATCCCTGCAGCTCTG	TCTTGTTCAGATCCCTGCAGCTCTGTGGCTG
TGGCTGCCTTGTTTTATTAC	CTCTGTGGCTGCCTTGTTTTATTACTGGCCA
GGCCATGTCAGTCGTCATAC	TTACTGGCCATGTCAGTCGTCATACTGGACC
TCATACTGGACCCCCCGCCC	AGTCGTCATACTGGACCCCCCGCCCCGGCCC
TGGACCCCCCGCCCCGGCCC	CATACTGGACCCCCCGCCCCGGCCCCGGTCC
CGCCCCGGCCCCGGTCCCGC	CCCCCCGCCCCGGCCCCGGTCCCGCAGGCGC
GCCCCGGTCCCGCAGGCGCA	CCCCGGCCCCGGTCCCGCAGGCGCACGGCTG
ATTTCCTCATCGACGTCTCC	CTCTGATTTCCTCATCGACGTCTCCAGGACT
TCAGAGCCCAGCAGAGCGTG	AGGACTCAGAGCCCAGCAGAGCGTGAGGGCA
CAGAGCCCAGCAGAGCGTGA	GGACTCAGAGCCCAGCAGAGCGTGAGGGCAC
CCAGCAGAGCGTGAGGGCAC	AGAGCCCAGCAGAGCGTGAGGGCACAGGTCT
GGTCTGACCTCCAGATCTTG	GCACAGGTCTGACCTCCAGATCTTGAGGTCG
CTTGAGGTCGTACCCTTTGC	CAGATCTTGAGGTCGTACCCTTTGCTGGGAG
TTGAGGTCGTACCCTTTGCT	AGATCTTGAGGTCGTACCCTTTGCTGGGAGC
TCTCCTTTTTGTTTTTTTTT	TTTCTTCTCCTTTTTGTTTTTTTTTTGGATA
TAACTTACTTTTATTCTTGC	TTGGATAACTTACTTTTATTCTTGCAGGCCG
TTACTTTTATTCTTGCAGGC	ATAACTTACTTTTATTCTTGCAGGCCGGAGT
TCTTGCAGGCCGGAGTGCAG	TTTATTCTTGCAGGCCGGAGTGCAGTGGTGC
TCACTGCAACTTTCGCCTTC	TCAGCTCACTGCAACTTTCGCCTTCTGGGTT
CACTGCAACTTTCGCCTTCT	CAGCTCACTGCAACTTTCGCCTTCTGGGTTC
AACTTTCGCCTTCTGGGTTC	ACTGCAACTTTCGCCTTCTGGGTTCAGGCAG
GCCTCAGCCTCCTGAGTAGC	CTCCTGCCTCAGCCTCCTGAGTAGCTGGTAT
TCCTGAGTAGCTGGTATTAG	CAGCCTCCTGAGTAGCTGGTATTAGAGGCGC
TTCGTATTTTTAGTAGAGAC	TAATTTTCGTATTTTTAGTAGAGACCGGGTT
TCGTATTTTTAGTAGAGACC	AATTTTCGTATTTTTAGTAGAGACCGGGTTT
GAGACCGGGTTTTGCTATGT	TAGTAGAGACCGGGTTTTGCTATGTTGGCTG
CCGGGTTTTGCTATGTTGGC	AGAGACCGGGTTTTGCTATGTTGGCTGGGCT
CGGGTTTTGCTATGTTGGCT	GAGACCGGGTTTTGCTATGTTGGCTGGGCTG
TTTTGCTATGTTGGCTGGGC	CCGGGTTTTGCTATGTTGGCTGGGCTGGTCT
GCCTCTGCCTCCCAAAGTGC	TGCCCGCCTCTGCCTCCCAAAGTGCTGGGAT
CCTCTGCCTCCCAAAGTGCT	GCCCGCCTCTGCCTCCCAAAGTGCTGGGATT
TGATGAAAAATGTTTAATCT	ACAATTGATGAAAAATGTTTAATCTTGGCCA
AAAAATGTTTAATCTTGGCC	TGATGAAAAATGTTTAATCTTGGCCAGGCAA
TGTTTAATCTTGGCCAGGCA	AAAAATGTTTAATCTTGGCCAGGCAAGGTGG
TTAATCTTGGCCAGGCAAGG	AATGTTTAATCTTGGCCAGGCAAGGTGGCTC
CGCCTGTAATCACAGCACTT	GCTCACGCCTGTAATCACAGCACTTTGGGAG
GCCTGTAATCACAGCACTTT	CTCACGCCTGTAATCACAGCACTTTGGGAGG
TGTAATCACAGCACTTTGGG	ACGCCTGTAATCACAGCACTTTGGGAGGCCA
CACAGCACTTTGGGAGGCCA	GTAATCACAGCACTTTGGGAGGCCAAGGCGG
AGCACTTTGGGAGGCCAAGG	ATCACAGCACTTTGGGAGGCCAAGGCGGGTG
GCACTTTGGGAGGCCAAGGC	TCACAGCACTTTGGGAGGCCAAGGCGGGTGG
CTTTGGGAGGCCAAGGCGGG	CAGCACTTTGGGAGGCCAAGGCGGGTGGATC
GGCGGGTGGATCACAAAATC	GCCAAGGCGGGTGGATCACAAAATCAGGAGT
TCAGGAGTTCAAGAGCAGCC	CAAAATCAGGAGTTCAAGAGCAGCCTGGCCA
CAAGAGCAGCCTGGCCAACA	GAGTTCAAGAGCAGCCTGGCCAACATGGAGA
AATACAAAATTAGCCAGCTG	CTAAAAATACAAAATTAGCCAGCTGTGGTGG
ACAAAATTAGCCAGCTGTGG	AAAATACAAAATTAGCCAGCTGTGGTGGCAC
TGCCTGTAATCCCAGCCACT	GCACATGCCTGTAATCCCAGCCACTTGGGAG
GCCTGTAATCCCAGCCACTT	CACATGCCTGTAATCCCAGCCACTTGGGAGG
TGTAATCCCAGCCACTTGGG	ATGCCTGTAATCCCAGCCACTTGGGAGGCTG
CCCAGCCACTTGGGAGGCTG	GTAATCCCAGCCACTTGGGAGGCTGAGGCAG
GCCACTTGGGAGGCTGAGGC	TCCCAGCCACTTGGGAGGCTGAGGCAGGAGA
GCAGGAGAATTGCTTTAACC	CTGAGGCAGGAGAATTGCTTTAACCCGGGAG
CAGGAGAATTGCTTTAACCC	TGAGGCAGGAGAATTGCTTTAACCCGGGAGG
GAGAATTGCTTTAACCCGGG	GGCAGGAGAATTGCTTTAACCCGGGAGGTGG
AATTGCTTTAACCCGGGAGG	AGGAGAATTGCTTTAACCCGGGAGGTGGAGT
GTGGAGTTTGCAGTGAGTCC	GGGAGGTGGAGTTTGCAGTGAGTCCAGGTCA
CATGCCACTGCATTCCAGCC	CAGGTCATGCCACTGCATTCCAGCCTGGGCA
ATGCCACTGCATTCCAGCCT	AGGTCATGCCACTGCATTCCAGCCTGGGCAA
AAGAACAGCCAGTATCAAAC	GAATTAAGAACAGCCAGTATCAAACTGGCCT
AAACTGGCCTGAAATCTGAT	GTATCAAACTGGCCTGAAATCTGATTGGGTT
AACTGGCCTGAAATCTGATT	TATCAAACTGGCCTGAAATCTGATTGGGTTC
CTGAAATCTGATTGGGTTCC	CTGGCCTGAAATCTGATTGGGTTCCTGGGCT
TGAAATCTGATTGGGTTCCT	TGGCCTGAAATCTGATTGGGTTCCTGGGCTC
CTAAGACACAAAATTAAACT	CCACACTAAGACACAAAATTAAACTAGGATG
GCAAATAACTTCATGTAGTT	TAATTGCAAATAACTTCATGTAGTTTGGCTA
GTTTGGCTAGCATTTCAAAA	ATGTAGTTTGGCTAGCATTTCAAAATGGATA
GCTAGCATTTCAAAATGGAT	GTTTGGCTAGCATTTCAAAATGGATAGGGAA
CTAGCATTTCAAAATGGATA	TTTGGCTAGCATTTCAAAATGGATAGGGAAT
ACATATTGCACTTTTCTGCT	ATTATACATATTGCACTTTTCTGCTAGGCTG
ATTGCACTTTTCTGCTAGGC	TACATATTGCACTTTTCTGCTAGGCTGGGCT
TTGCACTTTTCTGCTAGGCT	ACATATTGCACTTTTCTGCTAGGCTGGGCTA
GGCTGGGCTAGTATCTTCCA	TGCTAGGCTGGGCTAGTATCTTCCATGGCAA
CAGCATTACCAAAATCTTCC	ATCAACAGCATTACCAAAATCTTCCAGGATT
TTGTTTGTTTGTTTTTGAGA	TTGTTTTGTTTGTTTGTTTTTGAGACGGAGT
CGGAGTGTCACTCTGTCACC	TGAGACGGAGTGTCACTCTGTCACCCGGGCT
GGAGTGTCACTCTGTCACCC	GAGACGGAGTGTCACTCTGTCACCCGGGCTG
TGTCACTCTGTCACCCGGGC	CGGAGTGTCACTCTGTCACCCGGGCTGGAGT
TCACCCGGGCTGGAGTGCAG	CTCTGTCACCCGGGCTGGAGTGCAGTGGCGC
GGAGTGCAGTGGCGCAATCT	GGGCTGGAGTGCAGTGGCGCAATCTTGGCTC
CACTGAAACCTCTGCCTCCC	TGGCTCACTGAAACCTCTGCCTCCCAGGTTC
GCCTCCACCTCCCGAGTAGC	TTCCTGCCTCCACCTCCCGAGTAGCTGGGAT
CCTCCACCTCCCGAGTAGCT	TCCTGCCTCCACCTCCCGAGTAGCTGGGATT
TCCCGAGTAGCTGGGATTAC	CCACCTCCCGAGTAGCTGGGATTACAGGCGC
CAGGCGCACGCTGCCACGCC	GATTACAGGCGCACGCTGCCACGCCCGGCTA
TTTTTGTATTTTAGTAGAGA	CTAATTTTTTGTATTTTAGTAGAGACGGGGT
TTTTGTATTTTAGTAGAGAC	TAATTTTTTGTATTTTAGTAGAGACGGGGTT
TTTGTATTTTAGTAGAGACG	AATTTTTTGTATTTTAGTAGAGACGGGGTTT
GGGGTTTCACCGTGTTACCC	GAGACGGGGTTTCACCGTGTTACCCAGGCTG
TTTCACCGTGTTACCCAGGC	CGGGGTTTCACCGTGTTACCCAGGCTGGTCT
CCGTGTTACCCAGGCTGGTC	TTTCACCGTGTTACCCAGGCTGGTCTGGAAC
GGTCTGGAACTCCTGAGCTC	AGGCTGGTCTGGAACTCCTGAGCTCAGGCAA
CTCAGGCAATCCGCCTGCCT	CTGAGCTCAGGCAATCCGCCTGCCTCGGCCT
TCTCAAAGTGCTGAGATTAC	CGGCCTCTCAAAGTGCTGAGATTACAGGTGT
CAGGTGTGAGCCACTGCGCC	GATTACAGGTGTGAGCCACTGCGCCCGGCAC
CACTTTTAAAGTTAAACTTA	AAATACACTTTTAAAGTTAAACTTATGGAGG
TTTTAAAGTTAAACTTATGG	TACACTTTTAAAGTTAAACTTATGGAGGGAA
TTTAAAGTTAAACTTATGGA	ACACTTTTAAAGTTAAACTTATGGAGGGAAA
ATAGATTGTATGTCCTTTTT	TTGACATAGATTGTATGTCCTTTTTTGGTCC
CTTTTTTGGTCCCTCCATGA	ATGTCCTTTTTTGGTCCCTCCATGAAGGAGC
TTCACCCGTCAGAGTGACCG	TTCCCTTCACCCGTCAGAGTGACCGAGGCTG
CCCGTCAGAGTGACCGAGGC	CTTCACCCGTCAGAGTGACCGAGGCTGGGGA
CCGTCAGAGTGACCGAGGCT	TTCACCCGTCAGAGTGACCGAGGCTGGGGAC
CGTCAGAGTGACCGAGGCTG	TCACCCGTCAGAGTGACCGAGGCTGGGGACC
GACCCCAGAAGCCCCAGAGC	CTGGGGACCCCAGAAGCCCCAGAGCAGGCCC
CCCCAGAGCAGGCCCGAATC	AGAAGCCCCAGAGCAGGCCCGAATCTGGGAC
CCCAGAGCAGGCCCGAATCT	GAAGCCCCAGAGCAGGCCCGAATCTGGGACT
GCCCGAATCTGGGACTTCCA	AGCAGGCCCGAATCTGGGACTTCCACGGTCC
ATCTGGGACTTCCACGGTCC	CCCGAATCTGGGACTTCCACGGTCCTGGGGG
TCTGGGACTTCCACGGTCCT	CCGAATCTGGGACTTCCACGGTCCTGGGGGA
CTGGGACTTCCACGGTCCTG	CGAATCTGGGACTTCCACGGTCCTGGGGGAG
TGGGACTTCCACGGTCCTGG	GAATCTGGGACTTCCACGGTCCTGGGGGAGG
GACTTCCACGGTCCTGGGGG	TCTGGGACTTCCACGGTCCTGGGGGAGGGGT
ACTTCCACGGTCCTGGGGGA	CTGGGACTTCCACGGTCCTGGGGGAGGGGTG
CTTCCACGGTCCTGGGGGAG	TGGGACTTCCACGGTCCTGGGGGAGGGGTGC
ACGGTCCTGGGGGAGGGGTG	CTTCCACGGTCCTGGGGGAGGGGTGCGGGGA
CGGTCCTGGGGGAGGGGTGC	TTCCACGGTCCTGGGGGAGGGGTGCGGGGAC
GGTCCTGGGGGAGGGGTGCG	TCCACGGTCCTGGGGGAGGGGTGCGGGGACA
GGTGCGGGGACACTCACGTG	GGAGGGGTGCGGGGACACTCACGTGTGGCGC
GGGGACACTCACGTGTGGCG	GGTGCGGGGACACTCACGTGTGGCGCGGATG
TCACGTGTGGCGCGGATGTC	GACACTCACGTGTGGCGCGGATGTCCGGGGT
CACGTGTGGCGCGGATGTCC	ACACTCACGTGTGGCGCGGATGTCCGGGGTG
ACGTGTGGCGCGGATGTCCG	CACTCACGTGTGGCGCGGATGTCCGGGGTGT
CGCGGATGTCCGGGGTGTGA	TGTGGCGCGGATGTCCGGGGTGTGAAGGCAG
TGTCCGGGGTGTGAAGGCAG	GCGGATGTCCGGGGTGTGAAGGCAGCGGGCG
GTCCGGGGTGTGAAGGCAGC	CGGATGTCCGGGGTGTGAAGGCAGCGGGCGC
TGAAGGCAGCGGGCGCAGCT	GGGTGTGAAGGCAGCGGGCGCAGCTCGGCGG
AGGCAGCGGGCGCAGCTCGG	TGTGAAGGCAGCGGGCGCAGCTCGGCGGCGC
CGGGCGCAGCTCGGCGGCGC	GGCAGCGGGCGCAGCTCGGCGGCGCCGGAGG
GCGCAGCTCGGCGGCGCCGG	AGCGGGCGCAGCTCGGCGGCGCCGGAGGAGC
CGGAGGAGCCCTCTGCGCCC	GGCGCCGGAGGAGCCCTCTGCGCCCAGGAAC
TCTGCGCCCAGGAACAAGAC	AGCCCTCTGCGCCCAGGAACAAGACAGGGAA
CTGCGCCCAGGAACAAGACA	GCCCTCTGCGCCCAGGAACAAGACAGGGAAG
CAAGACAGGGAAGATGAAGC	AGGAACAAGACAGGGAAGATGAAGCCGGGGC
AAGACAGGGAAGATGAAGCC	GGAACAAGACAGGGAAGATGAAGCCGGGGCT
AGACAGGGAAGATGAAGCCG	GAACAAGACAGGGAAGATGAAGCCGGGGCTG
GGAAGATGAAGCCGGGGCTG	GACAGGGAAGATGAAGCCGGGGCTGAGGCGC
TGAAGCCGGGGCTGAGGCGC	GAAGATGAAGCCGGGGCTGAGGCGCAGGCGC
CCGGGGCTGAGGCGCAGGCG	TGAAGCCGGGGCTGAGGCGCAGGCGCGGGCG
CGGGGCTGAGGCGCAGGCGC	GAAGCCGGGGCTGAGGCGCAGGCGCGGGCGC
CTGAGGCGCAGGCGCGGGCG	CGGGGCTGAGGCGCAGGCGCGGGCGCGGCCT
GCGCAGGCGCGGGCGCGGCC	CTGAGGCGCAGGCGCGGGCGCGGCCTGGGGT
CGCAGGCGCGGGCGCGGCCT	TGAGGCGCAGGCGCGGGCGCGGCCTGGGGTG
GCAGGCGCGGGCGCGGCCTG	GAGGCGCAGGCGCGGGCGCGGCCTGGGGTGT
CGCGGGCGCGGCCTGGGGTG	GCAGGCGCGGGCGCGGCCTGGGGTGTGGCCT
GCGCGGCCTGGGGTGTGGCC	CGCGGGCGCGGCCTGGGGTGTGGCCTGGGGT
CGCGGCCTGGGGTGTGGCCT	GCGGGCGCGGCCTGGGGTGTGGCCTGGGGTG
GCGGCCTGGGGTGTGGCCTG	CGGGCGCGGCCTGGGGTGTGGCCTGGGGTGT
CTGGGGTGTGGCCTGGGGTG	GCGGCCTGGGGTGTGGCCTGGGGTGTGGCCT
GTGTGGCCTGGGGTGTGGCC	CTGGGGTGTGGCCTGGGGTGTGGCCTGGGGC
TGTGGCCTGGGGTGTGGCCT	TGGGGTGTGGCCTGGGGTGTGGCCTGGGGCG
GTGGCCTGGGGTGTGGCCTG	GGGGTGTGGCCTGGGGTGTGGCCTGGGGCGT
CTGGGGTGTGGCCTGGGGCG	GTGGCCTGGGGTGTGGCCTGGGGCGTGGCCT
GTGTGGCCTGGGGCGTGGCC	CTGGGGTGTGGCCTGGGGCGTGGCCTGGGGC
TGTGGCCTGGGGCGTGGCCT	TGGGGTGTGGCCTGGGGCGTGGCCTGGGGCG
GTGGCCTGGGGCGTGGCCTG	GGGGTGTGGCCTGGGGCGTGGCCTGGGGCGT
CTGGGGCGTGGCCTGGGGCG	GTGGCCTGGGGCGTGGCCTGGGGCGTGGCCT
GCGTGGCCTGGGGCGTGGCC	CTGGGGCGTGGCCTGGGGCGTGGCCTGGCCC
ACCACCCGCCCGCTCCGCCC	GCCCGACCACCCGCCCGCTCCGCCCAGGACC
TCCGCCCAGGACCCCCTCCC	CCCGCTCCGCCCAGGACCCCCTCCCAGGCCT
CCCCTCCCAGGCCTCAGCTC	AGGACCCCCTCCCAGGCCTCAGCTCCGGGCG
CCCTCCCAGGCCTCAGCTCC	GGACCCCCTCCCAGGCCTCAGCTCCGGGCGA
GGCCTCAGCTCCGGGCGACG	TCCCAGGCCTCAGCTCCGGGCGACGTGGAGT
CAGCTCCGGGCGACGTGGAG	GGCCTCAGCTCCGGGCGACGTGGAGTGGGGC
AGCTCCGGGCGACGTGGAGT	GCCTCAGCTCCGGGCGACGTGGAGTGGGGCG
GCTCCGGGCGACGTGGAGTG	CCTCAGCTCCGGGCGACGTGGAGTGGGGCGG
CCGGGCGACGTGGAGTGGGG	CAGCTCCGGGCGACGTGGAGTGGGGCGGTCC
GACGTGGAGTGGGGCGGTCC	CGGGCGACGTGGAGTGGGGCGGTCCTGGCGG
GTGGAGTGGGGCGGTCCTGG	GCGACGTGGAGTGGGGCGGTCCTGGCGGGCC
TGGAGTGGGGCGGTCCTGGC	CGACGTGGAGTGGGGCGGTCCTGGCGGGCCG
AGATGCCGTCCTGCGCTGCG	GGCCGAGATGCCGTCCTGCGCTGCGAGGGAC
GATGCCGTCCTGCGCTGCGA	GCCGAGATGCCGTCCTGCGCTGCGAGGGACC
CACCTTCGAGCTGCTGCGCG	GACGTCACCTTCGAGCTGCTGCGCGAGGGCG
ACCTTCGAGCTGCTGCGCGA	ACGTCACCTTCGAGCTGCTGCGCGAGGGCGA
GCTGCGCGAGGGCGAGACGA	GAGCTGCTGCGCGAGGGCGAGACGAAGGCCG
CGAGACGAAGGCCGTGAAGA	GAGGGCGAGACGAAGGCCGTGAAGACGGTCC
GTGAAGACGGTCCGCACCCC	AGGCCGTGAAGACGGTCCGCACCCCCGGGGC
TGAAGACGGTCCGCACCCCC	GGCCGTGAAGACGGTCCGCACCCCCGGGGCC
GAAGACGGTCCGCACCCCCG	GCCGTGAAGACGGTCCGCACCCCCGGGGCCG
GGTCCGCACCCCCGGGGCCG	AAGACGGTCCGCACCCCCGGGGCCGCGGCGA
GAACCTCGAGCTGATCTTCG	GCGGCGAACCTCGAGCTGATCTTCGTGGGGC
AACCTCGAGCTGATCTTCGT	CGGCGAACCTCGAGCTGATCTTCGTGGGGCC
ACCTCGAGCTGATCTTCGTG	GGCGAACCTCGAGCTGATCTTCGTGGGGCCC
TTCGTGGGGCCCCAGCACGC	TGATCTTCGTGGGGCCCCAGCACGCCGGCAA
CCCAGCACGCCGGCAACTAC	GGGGCCCCAGCACGCCGGCAACTACAGGTGC
ACAGGTGCCGCTACCGCTCC	CAACTACAGGTGCCGCTACCGCTCCTGGGTG
CAGGTGCCGCTACCGCTCCT	AACTACAGGTGCCGCTACCGCTCCTGGGTGC
GGTGCCCCACACCTTCGAAT	TCCTGGGTGCCCCACACCTTCGAATCGGAGC
ATCGGAGCTCAGCGACCCTG	TTCGAATCGGAGCTCAGCGACCCTGTGGAGC
CAGCGACCCTGTGGAGCTCC	GAGCTCAGCGACCCTGTGGAGCTCCTGGTGG
CGACCCTGTGGAGCTCCTGG	CTCAGCGACCCTGTGGAGCTCCTGGTGGCAG
CCTGTGGAGCTCCTGGTGGC	GCGACCCTGTGGAGCTCCTGGTGGCAGGTGA
GGTGGCAGGTGACGTTTCCC	CTCCTGGTGGCAGGTGACGTTTCCCTGGGTC
GTGGCAGGTGACGTTTCCCT	TCCTGGTGGCAGGTGACGTTTCCCTGGGTCC
GGTGACGTTTCCCTGGGTCC	TGGCAGGTGACGTTTCCCTGGGTCCCGGGTG
GTGACGTTTCCCTGGGTCCC	GGCAGGTGACGTTTCCCTGGGTCCCGGGTGC
TTTCCCTGGGTCCCGGGTGC	TGACGTTTCCCTGGGTCCCGGGTGCTGGTTC
TCCGTCTGCTGATGTTTGCC	CTGGTTCCGTCTGCTGATGTTTGCCTGGGCT
CCGTCTGCTGATGTTTGCCT	TGGTTCCGTCTGCTGATGTTTGCCTGGGCTG
CCTGGGCTGTGCCCACCTCC	GTTTGCCTGGGCTGTGCCCACCTCCAGGAGG
GGGCTGTGCCCACCTCCAGG	TGCCTGGGCTGTGCCCACCTCCAGGAGGGCC
GGCTGTGCCCACCTCCAGGA	GCCTGGGCTGTGCCCACCTCCAGGAGGGCCT
ACCTCCAGGAGGGCCTCTCC	TGCCCACCTCCAGGAGGGCCTCTCCCGGCTC
GCCTCTCCCGGCTCCTCCCT	GGAGGGCCTCTCCCGGCTCCTCCCTTGGGCA
CCTCTCCCGGCTCCTCCCTT	GAGGGCCTCTCCCGGCTCCTCCCTTGGGCAC
GCTCCTCCCTTGGGCACCCC	TCCCGGCTCCTCCCTTGGGCACCCCTGGTTA
TGGGCACCCCTGGTTAGCGC	TCCCTTGGGCACCCCTGGTTAGCGCTGGGTC
GGGCACCCCTGGTTAGCGCT	CCCTTGGGCACCCCTGGTTAGCGCTGGGTCT
GGTTAGCGCTGGGTCTCCCC	CCCCTGGTTAGCGCTGGGTCTCCCCAGGGCT
GTTAGCGCTGGGTCTCCCCA	CCCTGGTTAGCGCTGGGTCTCCCCAGGGCTC
CTGGGTCTCCCCAGGGCTCG	TAGCGCTGGGTCTCCCCAGGGCTCGTGGGGG
TGGGTCTCCCCAGGGCTCGT	AGCGCTGGGTCTCCCCAGGGCTCGTGGGGGA
GGGTCTCCCCAGGGCTCGTG	GCGCTGGGTCTCCCCAGGGCTCGTGGGGGAA
GGTCTCCCCAGGGCTCGTGG	CGCTGGGTCTCCCCAGGGCTCGTGGGGGAAT
CAGGGCTCGTGGGGGAATTG	CTCCCCAGGGCTCGTGGGGGAATTGCGGGCG
AGGGCTCGTGGGGGAATTGC	TCCCCAGGGCTCGTGGGGGAATTGCGGGCGA
TCGTGGGGGAATTGCGGGCG	AGGGCTCGTGGGGGAATTGCGGGCGAGGAAC
GGCGAGGAACCGCCCAGCAA	TTGCGGGCGAGGAACCGCCCAGCAAAGGCCC
CCCAGCAAAGGCCCTGCAGC	AACCGCCCAGCAAAGGCCCTGCAGCTGGAGG
AGCAAAGGCCCTGCAGCTGG	CGCCCAGCAAAGGCCCTGCAGCTGGAGGCGC
CCTGCAGCTGGAGGCGCAGA	AAGGCCCTGCAGCTGGAGGCGCAGATGGGGG
CTGCAGCTGGAGGCGCAGAT	AGGCCCTGCAGCTGGAGGCGCAGATGGGGGT
TGCAGCTGGAGGCGCAGATG	GGCCCTGCAGCTGGAGGCGCAGATGGGGGTC
GCAGCTGGAGGCGCAGATGG	GCCCTGCAGCTGGAGGCGCAGATGGGGGTCT
GGAGGCGCAGATGGGGGTCT	CAGCTGGAGGCGCAGATGGGGGTCTCGGCTG
GCGCAGATGGGGGTCTCGGC	TGGAGGCGCAGATGGGGGTCTCGGCTGGCAG
GCCGACCACGCGCTTCCTTC	TGGCAGCCGACCACGCGCTTCCTTCCGGGGG
CCGACCACGCGCTTCCTTCC	GGCAGCCGACCACGCGCTTCCTTCCGGGGGG
CGACCACGCGCTTCCTTCCG	GCAGCCGACCACGCGCTTCCTTCCGGGGGGG
GACCACGCGCTTCCTTCCGG	CAGCCGACCACGCGCTTCCTTCCGGGGGGGC
ACCACGCGCTTCCTTCCGGG	AGCCGACCACGCGCTTCCTTCCGGGGGGGCG
CCACGCGCTTCCTTCCGGGG	GCCGACCACGCGCTTCCTTCCGGGGGGGCGT
CTTCCTTCCGGGGGGGCGTC	ACGCGCTTCCTTCCGGGGGGGCGTCAGGGAG
TTCCTTCCGGGGGGGCGTCA	CGCGCTTCCTTCCGGGGGGGCGTCAGGGAGG
CTTCCGGGGGGGCGTCAGGG	GCTTCCTTCCGGGGGGGCGTCAGGGAGGTCG
CGGGGGGGCGTCAGGGAGGT	CCTTCCGGGGGGGCGTCAGGGAGGTCGGCCT
GGTCGGCCTTGATTTCCGCG	AGGGAGGTCGGCCTTGATTTCCGCGAGGAGG
CGGCCTTGATTTCCGCGAGG	GAGGTCGGCCTTGATTTCCGCGAGGAGGAGG
CCTTGATTTCCGCGAGGAGG	GTCGGCCTTGATTTCCGCGAGGAGGAGGGCA
CTTGATTTCCGCGAGGAGGA	TCGGCCTTGATTTCCGCGAGGAGGAGGGCAT
TTCCGCGAGGAGGAGGGCAT	TTGATTTCCGCGAGGAGGAGGGCATAGGATT
CTAGAAAGCTGATGCAGCCG	GTTGTCTAGAAAGCTGATGCAGCCGCGGGCC
TAGAAAGCTGATGCAGCCGC	TTGTCTAGAAAGCTGATGCAGCCGCGGGCCC
GCTGATGCAGCCGCGGGCCC	AGAAAGCTGATGCAGCCGCGGGCCCAGGGTG
CTGATGCAGCCGCGGGCCCA	GAAAGCTGATGCAGCCGCGGGCCCAGGGTGC
CCGCGGGCCCAGGGTGCTGT	TGCAGCCGCGGGCCCAGGGTGCTGTTGGTGT
GTTGGTGTCCTCAGAAGTGC	GTGCTGTTGGTGTCCTCAGAAGTGCCGGGGA
TTGGTGTCCTCAGAAGTGCC	TGCTGTTGGTGTCCTCAGAAGTGCCGGGGAT
TGGTGTCCTCAGAAGTGCCG	GCTGTTGGTGTCCTCAGAAGTGCCGGGGATT
CTCAGAAGTGCCGGGGATTC	GTGTCCTCAGAAGTGCCGGGGATTCTGGACT
AAGTGCCGGGGATTCTGGAC	CTCAGAAGTGCCGGGGATTCTGGACTGGCTC
TCCCCTCCTGTTGCAGCACA	CTCCCTCCCCTCCTGTTGCAGCACAAGGCCG
CTCCTGTTGCAGCACAAGGC	CTCCCCTCCTGTTGCAGCACAAGGCCGGGGT
TCCTGTTGCAGCACAAGGCC	TCCCCTCCTGTTGCAGCACAAGGCCGGGGTC
CCTGTTGCAGCACAAGGCCG	CCCCTCCTGTTGCAGCACAAGGCCGGGGTCT
CAGCACAAGGCCGGGGTCTC	TGTTGCAGCACAAGGCCGGGGTCTCTGGGGG
AGCACAAGGCCGGGGTCTCT	GTTGCAGCACAAGGCCGGGGTCTCTGGGGGG
GCACAAGGCCGGGGTCTCTG	TTGCAGCACAAGGCCGGGGTCTCTGGGGGGC
CACAAGGCCGGGGTCTCTGG	TGCAGCACAAGGCCGGGGTCTCTGGGGGGCT
ACAAGGCCGGGGTCTCTGGG	GCAGCACAAGGCCGGGGTCTCTGGGGGGCTG
GGCCGGGGTCTCTGGGGGGC	CACAAGGCCGGGGTCTCTGGGGGGCTGGAGA
AAGCCTCCCTCATTCCTCCC	TGGAGAAGCCTCCCTCATTCCTCCCAGGAAT
GAATTAATAAATGTGAAGAG	CCCAGGAATTAATAAATGTGAAGAGAGGCTC
GGCTCTGTTTAAAATGTCTT	AGAGAGGCTCTGTTTAAAATGTCTTTGGACT
TAAAATGTCTTTGGACTCCC	CTGTTTAAAATGTCTTTGGACTCCCAGGGCT
AAAATGTCTTTGGACTCCCA	TGTTTAAAATGTCTTTGGACTCCCAGGGCTG
TTTGGACTCCCAGGGCTGAG	ATGTCTTTGGACTCCCAGGGCTGAGTGGGCT
TTGGACTCCCAGGGCTGAGT	TGTCTTTGGACTCCCAGGGCTGAGTGGGCTG
ACTCCCAGGGCTGAGTGGGC	TTTGGACTCCCAGGGCTGAGTGGGCTGGGAT
CTCCCAGGGCTGAGTGGGCT	TTGGACTCCCAGGGCTGAGTGGGCTGGGATC
GGGATCTCGTGTCCTCAAAG	GGGCTGGGATCTCGTGTCCTCAAAGTGGATG
TCTCGTGTCCTCAAAGTGGA	TGGGATCTCGTGTCCTCAAAGTGGATGGGTT
CTCGTGTCCTCAAAGTGGAT	GGGATCTCGTGTCCTCAAAGTGGATGGGTTC
TCCTCAAAGTGGATGGGTTC	TCGTGTCCTCAAAGTGGATGGGTTCTGGGGT
CCTCAAAGTGGATGGGTTCT	CGTGTCCTCAAAGTGGATGGGTTCTGGGGTG
CTCAAAGTGGATGGGTTCTG	GTGTCCTCAAAGTGGATGGGTTCTGGGGTGG
AAAGTGGATGGGTTCTGGGG	TCCTCAAAGTGGATGGGTTCTGGGGTGGCTC
GGGTTCTGGGGTGGCTCCTG	TGGATGGGTTCTGGGGTGGCTCCTGAGGTAG
TGGGGTGGCTCCTGAGGTAG	GGTTCTGGGGTGGCTCCTGAGGTAGAGGAGT
TGGCTCCTGAGGTAGAGGAG	TGGGGTGGCTCCTGAGGTAGAGGAGTGGAGA
GAGGTAGAGGAGTGGAGAAC	CTCCTGAGGTAGAGGAGTGGAGAACTGGCTC
TCTTTTTTCTTTTTTGAGAC	TCTTTTCTTTTTTCTTTTTTGAGACAGGGTC
CTTTTTTCTTTTTTGAGACA	CTTTTCTTTTTTCTTTTTTGAGACAGGGTCT
AGGGTCTCACACTGTCACCC	GAGACAGGGTCTCACACTGTCACCCAGGCTG
TCTCACACTGTCACCCAGGC	CAGGGTCTCACACTGTCACCCAGGCTGGAGT
TGGAGTGCAGTGTTGCAGTC	CAGGCTGGAGTGCAGTGTTGCAGTCCGGCTC
CACTGCAGTTTTGACCTCCC	CGGCTCACTGCAGTTTTGACCTCCCAGGCTC
GCCTCAGCCTCCCAAGTAGC	CTCCTGCCTCAGCCTCCCAAGTAGCTGGGAG
CCTCAGCCTCCCAAGTAGCT	TCCTGCCTCAGCCTCCCAAGTAGCTGGGAGC
CTCCCAAGTAGCTGGGAGCC	TCAGCCTCCCAAGTAGCTGGGAGCCTGGGCA
TCCCAAGTAGCTGGGAGCCT	CAGCCTCCCAAGTAGCTGGGAGCCTGGGCAT
TGGGCATGCATCGCCACGTC	GAGCCTGGGCATGCATCGCCACGTCTGGCTA
AATTATTATTTTTTGTAGAC	TGGCTAATTATTATTTTTTGTAGACAGGGTC
ATTATTATTTTTTGTAGACA	GGCTAATTATTATTTTTTGTAGACAGGGTCT
CCAAGCTTGTCTTGAACTCC	GTTGCCCAAGCTTGTCTTGAACTCCTGGCCT
ACCTCAGCCTCCTGAGTAGC	CTCCCACCTCAGCCTCCTGAGTAGCTGGGAC
CCTCAGCCTCCTGAGTAGCT	TCCCACCTCAGCCTCCTGAGTAGCTGGGACT
TCCTGAGTAGCTGGGACTAC	CAGCCTCCTGAGTAGCTGGGACTACAGGCAT
CAGGCATGAGCCACCATGCC	GACTACAGGCATGAGCCACCATGCCTGGCCA
TGAGTCTCACTATGTTGCCC	AGAGATGAGTCTCACTATGTTGCCCAGGCTG
TCTCACTATGTTGCCCAGGC	ATGAGTCTCACTATGTTGCCCAGGCTGGTCT
CCAGGCTGGTCTTGAACTCT	GTTGCCCAGGCTGGTCTTGAACTCTTGGGCT
CAGGCTGGTCTTGAACTCTT	TTGCCCAGGCTGGTCTTGAACTCTTGGGCTC
GCCTCAGCCTCCCAAAGTGT	CTCCCGCCTCAGCCTCCCAAAGTGTTGGGAT
CCTCAGCCTCCCAAAGTGTT	TCCCGCCTCAGCCTCCCAAAGTGTTGGGATT
TCCCAAAGTGTTGGGATTAC	CAGCCTCCCAAAGTGTTGGGATTACAGGTGT
CAGGTGTGAGCCACAGCACC	GATTACAGGTGTGAGCCACAGCACCTGGCCA
CTGGCCAACCAACACTTCTC	AGCACCTGGCCAACCAACACTTCTCAGGGCC
TGGCCAACCAACACTTCTCA	GCACCTGGCCAACCAACACTTCTCAGGGCCT
TCTTTCATCTGTGCTCTTCC	GGGCCTCTTTCATCTGTGCTCTTCCAGGATG
GGATGCTGCCTCTTACTCCC	TTCCAGGATGCTGCCTCTTACTCCCTGGGCA
GATGCTGCCTCTTACTCCCT	TCCAGGATGCTGCCTCTTACTCCCTGGGCAC
CTCTTACTCCCTGGGCACCT	GCTGCCTCTTACTCCCTGGGCACCTCGGCCT
ACTCCCTGGGCACCTCGGCC	CTCTTACTCCCTGGGCACCTCGGCCTGGTCC
CACCTCGGCCTGGTCCCAGC	CTGGGCACCTCGGCCTGGTCCCAGCAGGTAT
CGGCCTGGTCCCAGCAGGTA	CACCTCGGCCTGGTCCCAGCAGGTATGGGCA
GGCCTGGTCCCAGCAGGTAT	ACCTCGGCCTGGTCCCAGCAGGTATGGGCAG
CAGGTATGGGCAGTTGCTTG	CCCAGCAGGTATGGGCAGTTGCTTGAGGCTC
ACATCAACCCCATCACCAAG	CGACCACATCAACCCCATCACCAAGAGGAGG
TCAACCCCATCACCAAGAGG	CCACATCAACCCCATCACCAAGAGGAGGTTC
CCATCACCAAGAGGAGGTTC	CAACCCCATCACCAAGAGGAGGTTCAGGGAA
CATCACCAAGAGGAGGTTCA	AACCCCATCACCAAGAGGAGGTTCAGGGAAG
TTCAGGGAAGCTGCATTTTG	GGAGGTTCAGGGAAGCTGCATTTTGTGGTCT
TGGTCTTGTCCTCCCAGTCC	TTTTGTGGTCTTGTCCTCCCAGTCCAGGGTG
GGTCTTGTCCTCCCAGTCCA	TTTGTGGTCTTGTCCTCCCAGTCCAGGGTGG
CTTGTCCTCCCAGTCCAGGG	GTGGTCTTGTCCTCCCAGTCCAGGGTGGTAG
CCAGTCCAGGGTGGTAGTGC	TCCTCCCAGTCCAGGGTGGTAGTGCTGGGCT
CAGTCCAGGGTGGTAGTGCT	CCTCCCAGTCCAGGGTGGTAGTGCTGGGCTG
CCAGCCTCCCACAGCAGAGC	TGTTCCCAGCCTCCCACAGCAGAGCTGGACG
CACAGCAGAGCTGGACGCTG	CCTCCCACAGCAGAGCTGGACGCTGTGGAAA
AGAGCTGGACGCTGTGGAAA	ACAGCAGAGCTGGACGCTGTGGAAATGGCTG
CTGGACGCTGTGGAAATGGC	CAGAGCTGGACGCTGTGGAAATGGCTGGATT
ACCACTGCCGAGTTTCTGCC	TCCCAACCACTGCCGAGTTTCTGCCTGGAGC
GCCGAGTTTCTGCCTGGAGC	CCACTGCCGAGTTTCTGCCTGGAGCAGGGCC
CCGAGTTTCTGCCTGGAGCA	CACTGCCGAGTTTCTGCCTGGAGCAGGGCCT
CTGCCTGGAGCAGGGCCTCA	AGTTTCTGCCTGGAGCAGGGCCTCAAGGCCC
GGAGCAGGGCCTCAAGGCCC	TGCCTGGAGCAGGGCCTCAAGGCCCTGGCAC
CAACGAATTTGCTAGTGATC	TTTTTCAACGAATTTGCTAGTGATCTGGTTT
CTCTCTCTCTTTCTTGCTAG	GTGTCCTCTCTCTCTTTCTTGCTAGTGGTTT
GAATTTTGCTCTTGTTGCCC	AGACAGAATTTTGCTCTTGTTGCCCAGGCTG
TTTGCTCTTGTTGCCCAGGC	AGAATTTTGCTCTTGTTGCCCAGGCTGGAGT
TTGCCCAGGCTGGAGTGCAA	TCTTGTTGCCCAGGCTGGAGTGCAATGGCGT
GGAGTGCAATGGCGTGATCT	AGGCTGGAGTGCAATGGCGTGATCTTGGCTC
TCACAGCAACCTCTACCTCC	TTGGCTCACAGCAACCTCTACCTCCTGGGTT
CACAGCAACCTCTACCTCCT	TGGCTCACAGCAACCTCTACCTCCTGGGTTC
GCCTCAGCCTCCTGAGTAGC	CTCGTGCCTCAGCCTCCTGAGTAGCTGGGCT
CCTCAGCCTCCTGAGTAGCT	TCGTGCCTCAGCCTCCTGAGTAGCTGGGCTG
TCCTGAGTAGCTGGGCTGAC	CAGCCTCCTGAGTAGCTGGGCTGACAGGCAC
TTTTATGTTTTTAGTAGAGA	CTAATTTTTATGTTTTTAGTAGAGATGGGGT
TTTATGTTTTTAGTAGAGAT	TAATTTTTATGTTTTTAGTAGAGATGGGGTT
TTATGTTTTTAGTAGAGATG	AATTTTTATGTTTTTAGTAGAGATGGGGTTT
GAGATGGGGTTTCACCTTGT	TAGTAGAGATGGGGTTTCACCTTGTTGGGTG
AGATGGGGTTTCACCTTGTT	AGTAGAGATGGGGTTTCACCTTGTTGGGTGG
TGGGGTTTCACCTTGTTGGG	AGAGATGGGGTTTCACCTTGTTGGGTGGCCA
TTTCACCTTGTTGGGTGGCC	TGGGGTTTCACCTTGTTGGGTGGCCAGGCTG
ACCTTGTTGGGTGGCCAGGC	GTTTCACCTTGTTGGGTGGCCAGGCTGGTCT
GCCTCAGCCTCCCAAAGTGC	CACCCGCCTCAGCCTCCCAAAGTGCTGGGAT
CCTCAGCCTCCCAAAGTGCT	ACCCGCCTCAGCCTCCCAAAGTGCTGGGATT
TCCCAAAGTGCTGGGATTAC	CAGCCTCCCAAAGTGCTGGGATTACAGGGGT
CCCAAAGTGCTGGGATTACA	AGCCTCCCAAAGTGCTGGGATTACAGGGGTG
CCAAAGTGCTGGGATTACAG	GCCTCCCAAAGTGCTGGGATTACAGGGGTGA
TTTATTTTAGCCATTCTAAT	AAAAGTTTATTTTAGCCATTCTAATAGGTAT
TATGTAGACATATCTAATAG	ATAGGTATGTAGACATATCTAATAGTGGTTT
TTTTGCACACTTTAAAATAT	ATATATTTTGCACACTTTAAAATATTGGGTT
TTTGCACACTTTAAAATATT	TATATTTTGCACACTTTAAAATATTGGGTTG
CATCAAAGATGCTATATAGA	CATTTCATCAAAGATGCTATATAGATGGCAA
ATAGATGGCAACTAAGCACT	GCTATATAGATGGCAACTAAGCACTTGGGGA
TAGATGGCAACTAAGCACTT	CTATATAGATGGCAACTAAGCACTTGGGGAA
AGATGGCAACTAAGCACTTG	TATATAGATGGCAACTAAGCACTTGGGGAAA
CTTAACATCATCAGACATTA	AAATGCTTAACATCATCAGACATTAAGGAAA
TCAGACATTAAGGAAACGCA	CATCATCAGACATTAAGGAAACGCAAGGAAA
TGTCTACATACCTATTAGAA	AGATATGTCTACATACCTATTAGAATGGCTA
AACTTTTTAAAAAACTAAGC	AAATAAACTTTTTAAAAAACTAAGCTGGGGC
ACTTTTTAAAAAACTAAGCT	AATAAACTTTTTAAAAAACTAAGCTGGGGCT
CTTTTTAAAAAACTAAGCTG	ATAAACTTTTTAAAAAACTAAGCTGGGGCTG
TTAAAAAACTAAGCTGGGGC	ACTTTTTAAAAAACTAAGCTGGGGCTGGGCG
TAAAAAACTAAGCTGGGGCT	CTTTTTAAAAAACTAAGCTGGGGCTGGGCGT
AACTAAGCTGGGGCTGGGCG	TAAAAAACTAAGCTGGGGCTGGGCGTGGTGG
TAAGCTGGGGCTGGGCGTGG	AAAACTAAGCTGGGGCTGGGCGTGGTGGCTC
CCCCTGTAATCCCAGCACTT	GCTCACCCCTGTAATCCCAGCACTTTGGGAG
CCCTGTAATCCCAGCACTTT	CTCACCCCTGTAATCCCAGCACTTTGGGAGG
TGTAATCCCAGCACTTTGGG	ACCCCTGTAATCCCAGCACTTTGGGAGGCTG
CCCAGCACTTTGGGAGGCTG	GTAATCCCAGCACTTTGGGAGGCTGAGGCGG
AGCACTTTGGGAGGCTGAGG	ATCCCAGCACTTTGGGAGGCTGAGGCGGGTG
GCACTTTGGGAGGCTGAGGC	TCCCAGCACTTTGGGAGGCTGAGGCGGGTGG
CTTTGGGAGGCTGAGGCGGG	CAGCACTTTGGGAGGCTGAGGCGGGTGGATC
CGGGTGGATCACTTGAGCTC	TGAGGCGGGTGGATCACTTGAGCTCAGGAGT
GATCACTTGAGCTCAGGAGT	GGGTGGATCACTTGAGCTCAGGAGTTGGAGA
TCAGGAGTTGGAGACCAGCC	TGAGCTCAGGAGTTGGAGACCAGCCTGGCCA
ACCAGCCTGGCCACCCAACA	TGGAGACCAGCCTGGCCACCCAACAAGGTGA
CTAAAAACATAAAAATTAGC	CTCTACTAAAAACATAAAAATTAGCTGGGTG
TAAAAACATAAAAATTAGCT	TCTACTAAAAACATAAAAATTAGCTGGGTGT
ACATAAAAATTAGCTGGGTG	TAAAAACATAAAAATTAGCTGGGTGTGGTGG
TAAAAATTAGCTGGGTGTGG	AAACATAAAAATTAGCTGGGTGTGGTGGTGG
AAATTAGCTGGGTGTGGTGG	CATAAAAATTAGCTGGGTGTGGTGGTGGGTG
AATTAGCTGGGTGTGGTGGT	ATAAAAATTAGCTGGGTGTGGTGGTGGGTGC
GCCTGTCAGCCCAGCTACTC	TGGGTGCCTGTCAGCCCAGCTACTCAGGAGG
TGTCAGCCCAGCTACTCAGG	GTGCCTGTCAGCCCAGCTACTCAGGAGGCTG
CCCAGCTACTCAGGAGGCTG	GTCAGCCCAGCTACTCAGGAGGCTGAGGCAC
CACGAGAATCACTTGAACCC	TGAGGCACGAGAATCACTTGAACCCAGGAGG
GAGAATCACTTGAACCCAGG	GGCACGAGAATCACTTGAACCCAGGAGGTAG
CACTTGAACCCAGGAGGTAG	AGAATCACTTGAACCCAGGAGGTAGAGGTTG
CACGCCATTGCACTCCAGCC	AAGATCACGCCATTGCACTCCAGCCTGGGCA
ACGCCATTGCACTCCAGCCT	AGATCACGCCATTGCACTCCAGCCTGGGCAA
AAAAACAAATAAACAAGAAA	GTCTCAAAAACAAATAAACAAGAAAAGGTTT
CACTAGCAAGAAAGAGAGAG	TAAACCACTAGCAAGAAAGAGAGAGAGGACA
AAAGAGAGAGAGGACACATC	GCAAGAAAGAGAGAGAGGACACATCAGGCTT
TAGACTGTGCAGACATTAAA	CATCATAGACTGTGCAGACATTAAAAGGCAT
GTGCAGACATTAAAAGGCAT	AGACTGTGCAGACATTAAAAGGCATAGGCAT
TTAAAAGGCATAGGCATATT	AGACATTAAAAGGCATAGGCATATTAGGAAC
TTAGGAACTAGATATTACTA	GCATATTAGGAACTAGATATTACTAAGGCAG
AAACACAATTCATCAACTAT	TTGAAAAACACAATTCATCAACTATTGGTTG
ATACGCATCTTCTGTGTGCC	TACTGATACGCATCTTCTGTGTGCCAGGGCC
TACGCATCTTCTGTGTGCCA	ACTGATACGCATCTTCTGTGTGCCAGGGCCT
TTCTGTGTGCCAGGGCCTTG	GCATCTTCTGTGTGCCAGGGCCTTGAGGCCC
GGGCCTTGAGGCCCTGCTCC	TGCCAGGGCCTTGAGGCCCTGCTCCAGGCAG
CCCTGCTCCAGGCAGAAACT	TGAGGCCCTGCTCCAGGCAGAAACTCGGCAG
TCCAGGCAGAAACTCGGCAG	CCTGCTCCAGGCAGAAACTCGGCAGTGGTTG
GGCAGAAACTCGGCAGTGGT	CTCCAGGCAGAAACTCGGCAGTGGTTGGGAA
GCAGAAACTCGGCAGTGGTT	TCCAGGCAGAAACTCGGCAGTGGTTGGGAAG
AAACTCGGCAGTGGTTGGGA	GGCAGAAACTCGGCAGTGGTTGGGAAGGCAT
GGAAGGCATCAGATGTCAGA	GGTTGGGAAGGCATCAGATGTCAGATGGCAC
CAGATGTCAGATGGCACAAG	GGCATCAGATGTCAGATGGCACAAGAGGACT
CACAAGAGGACTCAGAGCTG	GATGGCACAAGAGGACTCAGAGCTGAGGGAT
ACAAGAGGACTCAGAGCTGA	ATGGCACAAGAGGACTCAGAGCTGAGGGATA
GACTCAGAGCTGAGGGATAA	AAGAGGACTCAGAGCTGAGGGATAATGGGAA
ACTCAGAGCTGAGGGATAAT	AGAGGACTCAGAGCTGAGGGATAATGGGAAA
GATAATGGGAAAGAACACAG	TGAGGGATAATGGGAAAGAACACAGAGGAAT
CACAGCGTCCAGCTCTGCTG	ATTTCCACAGCGTCCAGCTCTGCTGTGGGAG
ACAGCGTCCAGCTCTGCTGT	TTTCCACAGCGTCCAGCTCTGCTGTGGGAGG
GCGTCCAGCTCTGCTGTGGG	CCACAGCGTCCAGCTCTGCTGTGGGAGGCTG
CCAGCTCTGCTGTGGGAGGC	AGCGTCCAGCTCTGCTGTGGGAGGCTGGGAA
CAGCTCTGCTGTGGGAGGCT	GCGTCCAGCTCTGCTGTGGGAGGCTGGGAAC
ACAGCCCAGCACTACCACCC	TGGGAACAGCCCAGCACTACCACCCTGGACT
CCAGCACTACCACCCTGGAC	ACAGCCCAGCACTACCACCCTGGACTGGGAG
CAGCACTACCACCCTGGACT	CAGCCCAGCACTACCACCCTGGACTGGGAGG
CACTACCACCCTGGACTGGG	CCCAGCACTACCACCCTGGACTGGGAGGACA
AGCTTCCCTGAACCTCCTCT	AATGCAGCTTCCCTGAACCTCCTCTTGGTGA
CCTGAACCTCCTCTTGGTGA	GCTTCCCTGAACCTCCTCTTGGTGATGGGGT
CTGAACCTCCTCTTGGTGAT	CTTCCCTGAACCTCCTCTTGGTGATGGGGTT
TGAACCTCCTCTTGGTGATG	TTCCCTGAACCTCCTCTTGGTGATGGGGTTG
TCTTGGTGATGGGGTTGATG	CCTCCTCTTGGTGATGGGGTTGATGTGGTCG
TGATGGGGTTGATGTGGTCG	CTTGGTGATGGGGTTGATGTGGTCGAGGTAG
GGTTGATGTGGTCGAGGTAG	GATGGGGTTGATGTGGTCGAGGTAGAGGTGA
GAGGTAGAGGTGAGTATGTC	TGGTCGAGGTAGAGGTGAGTATGTCTGGAGC
AAGCAACTGCCCATACCTGC	GCCTCAAGCAACTGCCCATACCTGCTGGGAC
AGCAACTGCCCATACCTGCT	CCTCAAGCAACTGCCCATACCTGCTGGGACC
TGCCCATACCTGCTGGGACC	GCAACTGCCCATACCTGCTGGGACCAGGCCG
TACCTGCTGGGACCAGGCCG	GCCCATACCTGCTGGGACCAGGCCGAGGTGC
GGGACCAGGCCGAGGTGCCC	CTGCTGGGACCAGGCCGAGGTGCCCAGGGAG
GGACCAGGCCGAGGTGCCCA	TGCTGGGACCAGGCCGAGGTGCCCAGGGAGT
CGAGGTGCCCAGGGAGTAAG	CAGGCCGAGGTGCCCAGGGAGTAAGAGGCAG
GGGAGTAAGAGGCAGCATCC	GCCCAGGGAGTAAGAGGCAGCATCCTGGAAG
TGGAAGAGCACAGATGAAAG	CATCCTGGAAGAGCACAGATGAAAGAGGCCC
AAAGAGGCCCTGAGAAGTGT	AGATGAAAGAGGCCCTGAGAAGTGTTGGTTG
AGGCCCTGAGAAGTGTTGGT	GAAAGAGGCCCTGAGAAGTGTTGGTTGGCCA
CTGAGAAGTGTTGGTTGGCC	AGGCCCTGAGAAGTGTTGGTTGGCCAGGTGC
TGTTGGTTGGCCAGGTGCTG	AGAAGTGTTGGTTGGCCAGGTGCTGTGGCTC
CACCTGTAATCCCAACACTT	GCTCACACCTGTAATCCCAACACTTTGGGAG
ACCTGTAATCCCAACACTTT	CTCACACCTGTAATCCCAACACTTTGGGAGG
TGTAATCCCAACACTTTGGG	ACACCTGTAATCCCAACACTTTGGGAGGCTG
CCCAACACTTTGGGAGGCTG	GTAATCCCAACACTTTGGGAGGCTGAGGCGG
AACACTTTGGGAGGCTGAGG	ATCCCAACACTTTGGGAGGCTGAGGCGGGAG
ACACTTTGGGAGGCTGAGGC	TCCCAACACTTTGGGAGGCTGAGGCGGGAGG
CTTTGGGAGGCTGAGGCGGG	CAACACTTTGGGAGGCTGAGGCGGGAGGATC
CCAAGAGTTCAAGACCAGCC	TGAGCCCAAGAGTTCAAGACCAGCCTGGGCA
CAAGAGTTCAAGACCAGCCT	GAGCCCAAGAGTTCAAGACCAGCCTGGGCAA
ATAGAAAGAAAAATGTGAGT	AAATAATAGAAAGAAAAATGTGAGTTGGCCA
AAGAAAAATGTGAGTTGGCC	ATAGAAAGAAAAATGTGAGTTGGCCAGGCAT
AAATGTGAGTTGGCCAGGCA	AAGAAAAATGTGAGTTGGCCAGGCATGGTGG
TGTGAGTTGGCCAGGCATGG	AAAAATGTGAGTTGGCCAGGCATGGTGGCTC
GCCTGTAGTCCCAGCTACTC	CTCATGCCTGTAGTCCCAGCTACTCAGGAGG
TGTAGTCCCAGCTACTCAGG	ATGCCTGTAGTCCCAGCTACTCAGGAGGCTG
CCCAGCTACTCAGGAGGCTG	GTAGTCCCAGCTACTCAGGAGGCTGAGGTGG
AGCTACTCAGGAGGCTGAGG	GTCCCAGCTACTCAGGAGGCTGAGGTGGGAG
GCTACTCAGGAGGCTGAGGT	TCCCAGCTACTCAGGAGGCTGAGGTGGGAGG
ACTCAGGAGGCTGAGGTGGG	CAGCTACTCAGGAGGCTGAGGTGGGAGGATC
TGAGGTGGGAGGATCACTTA	GAGGCTGAGGTGGGAGGATCACTTAAGGCCA
TGGGAGGATCACTTAAGGCC	TGAGGTGGGAGGATCACTTAAGGCCAGGAGT
CCAGGAGTTCAAGACAAGCT	TAAGGCCAGGAGTTCAAGACAAGCTTGGGCA
CAGGAGTTCAAGACAAGCTT	AAGGCCAGGAGTTCAAGACAAGCTTGGGCAA
AAATAATAATTAGCCAGACG	ACAAAAAATAATAATTAGCCAGACGTGGCGA
AGACGTGGCGATGCATGCCC	TAGCCAGACGTGGCGATGCATGCCCAGGCTC
TGCCCAGGCTCCCAGCTACT	ATGCATGCCCAGGCTCCCAGCTACTTGGGAG
GCCCAGGCTCCCAGCTACTT	TGCATGCCCAGGCTCCCAGCTACTTGGGAGG
CAGGCTCCCAGCTACTTGGG	ATGCCCAGGCTCCCAGCTACTTGGGAGGCTG
CCCAGCTACTTGGGAGGCTG	AGGCTCCCAGCTACTTGGGAGGCTGAGGCAG
GCTACTTGGGAGGCTGAGGC	TCCCAGCTACTTGGGAGGCTGAGGCAGGAGG
ACTTGGGAGGCTGAGGCAGG	CAGCTACTTGGGAGGCTGAGGCAGGAGGATC
GCAGGAGGATCGCTTGAGCC	CTGAGGCAGGAGGATCGCTTGAGCCTGGGAG
CAGGAGGATCGCTTGAGCCT	TGAGGCAGGAGGATCGCTTGAGCCTGGGAGG
GAGGATCGCTTGAGCCTGGG	GGCAGGAGGATCGCTTGAGCCTGGGAGGTCA
AGGTCAAAACTGCAGTGAGC	CTGGGAGGTCAAAACTGCAGTGAGCCGGACT
TGCAACACTGCACTCCAGCC	CGGACTGCAACACTGCACTCCAGCCTGGGTG
GCAACACTGCACTCCAGCCT	GGACTGCAACACTGCACTCCAGCCTGGGTGA
GTTCTCCACTCCTCTACCTC	AGCCAGTTCTCCACTCCTCTACCTCAGGAGC
CCCAGAACCCATCCACTTTG	GCCACCCCAGAACCCATCCACTTTGAGGACA
GATCCCAGCCCACTCAGCCC	CACGAGATCCCAGCCCACTCAGCCCTGGGAG
ATCCCAGCCCACTCAGCCCT	ACGAGATCCCAGCCCACTCAGCCCTGGGAGT
TCTTCACATTTATTAATTCC	GCCTCTCTTCACATTTATTAATTCCTGGGAG
CTTCACATTTATTAATTCCT	CCTCTCTTCACATTTATTAATTCCTGGGAGG
CACATTTATTAATTCCTGGG	CTCTTCACATTTATTAATTCCTGGGAGGAAT
ATTAATTCCTGGGAGGAATG	CATTTATTAATTCCTGGGAGGAATGAGGGAG
TTAATTCCTGGGAGGAATGA	ATTTATTAATTCCTGGGAGGAATGAGGGAGG
ATTCCTGGGAGGAATGAGGG	TATTAATTCCTGGGAGGAATGAGGGAGGCTT
CTCCAGCCCCCCAGAGACCC	GGCTTCTCCAGCCCCCCAGAGACCCCGGCCT
CCCCGGCCTTGTGCTGCAAC	AGAGACCCCGGCCTTGTGCTGCAACAGGAGG
CGGCCTTGTGCTGCAACAGG	GACCCCGGCCTTGTGCTGCAACAGGAGGGGA
GGCCTTGTGCTGCAACAGGA	ACCCCGGCCTTGTGCTGCAACAGGAGGGGAG
GCCTTGTGCTGCAACAGGAG	CCCCGGCCTTGTGCTGCAACAGGAGGGGAGG
TTGTGCTGCAACAGGAGGGG	CGGCCTTGTGCTGCAACAGGAGGGGAGGGAG
TGTGCTGCAACAGGAGGGGA	GGCCTTGTGCTGCAACAGGAGGGGAGGGAGC
GGGAGCCAGTCCAGAATCCC	GGGGAGGGAGCCAGTCCAGAATCCCCGGCAC
CAGAATCCCCGGCACTTCTG	CAGTCCAGAATCCCCGGCACTTCTGAGGACA
TGAGGACACCAACAGCACCC	ACTTCTGAGGACACCAACAGCACCCTGGGCC
GAGGACACCAACAGCACCCT	CTTCTGAGGACACCAACAGCACCCTGGGCCC
CCAACAGCACCCTGGGCCCG	GGACACCAACAGCACCCTGGGCCCGCGGCTG
TGCATCAGCTTTCTAGACAA	GCGGCTGCATCAGCTTTCTAGACAACGGGAG
GCATCAGCTTTCTAGACAAC	CGGCTGCATCAGCTTTCTAGACAACGGGAGA
ACAACGGGAGAAAAGAGAAA	TCTAGACAACGGGAGAAAAGAGAAATGGTGG
ACGGGAGAAAAGAGAAATGG	AGACAACGGGAGAAAAGAGAAATGGTGGAGG
GGAGAAAAGAGAAATGGTGG	CAACGGGAGAAAAGAGAAATGGTGGAGGAGG
GAAAAGAGAAATGGTGGAGG	CGGGAGAAAAGAGAAATGGTGGAGGAGGGGA
AAAAGAGAAATGGTGGAGGA	GGGAGAAAAGAGAAATGGTGGAGGAGGGGAA
AAAGAGAAATGGTGGAGGAG	GGAGAAAAGAGAAATGGTGGAGGAGGGGAAA
ATCCTATGCCCTCCTCCTCG	GGGAAATCCTATGCCCTCCTCCTCGCGGAAA
CCTCCTCCTCGCGGAAATCA	TATGCCCTCCTCCTCGCGGAAATCAAGGCCG
CGACCTCCCTGACGCCCCCC	AAGGCCGACCTCCCTGACGCCCCCCCGGAAG
CTCCCTGACGCCCCCCCGGA	CCGACCTCCCTGACGCCCCCCCGGAAGGAAG
CCCCCCCGGAAGGAAGCGCG	TGACGCCCCCCCGGAAGGAAGCGCGTGGTCG
CCCGGAAGGAAGCGCGTGGT	GCCCCCCCGGAAGGAAGCGCGTGGTCGGCTG
CCATCTGCGCCTCCAGCTGC	GACCCCCATCTGCGCCTCCAGCTGCAGGGCC
CATCTGCGCCTCCAGCTGCA	ACCCCCATCTGCGCCTCCAGCTGCAGGGCCT
TCCAGCTGCAGGGCCTTTGC	GCGCCTCCAGCTGCAGGGCCTTTGCTGGGCG
CCAGCTGCAGGGCCTTTGCT	CGCCTCCAGCTGCAGGGCCTTTGCTGGGCGG
GCTGCAGGGCCTTTGCTGGG	CTCCAGCTGCAGGGCCTTTGCTGGGCGGTTC
CGCAATTCCCCCACGAGCCC	TCGCCCGCAATTCCCCCACGAGCCCTGGGGA
GCAATTCCCCCACGAGCCCT	CGCCCGCAATTCCCCCACGAGCCCTGGGGAG
CAATTCCCCCACGAGCCCTG	GCCCGCAATTCCCCCACGAGCCCTGGGGAGA
GGGGAGACCCAGCGCTAACC	GCCCTGGGGAGACCCAGCGCTAACCAGGGGT
GGGAGACCCAGCGCTAACCA	CCCTGGGGAGACCCAGCGCTAACCAGGGGTG
GGAGACCCAGCGCTAACCAG	CCTGGGGAGACCCAGCGCTAACCAGGGGTGC
GCGCTAACCAGGGGTGCCCA	ACCCAGCGCTAACCAGGGGTGCCCAAGGGAG
CGCTAACCAGGGGTGCCCAA	CCCAGCGCTAACCAGGGGTGCCCAAGGGAGG
TAACCAGGGGTGCCCAAGGG	AGCGCTAACCAGGGGTGCCCAAGGGAGGAGC
GGGGTGCCCAAGGGAGGAGC	AACCAGGGGTGCCCAAGGGAGGAGCCGGGAG
GGGTGCCCAAGGGAGGAGCC	ACCAGGGGTGCCCAAGGGAGGAGCCGGGAGA
CCCAAGGGAGGAGCCGGGAG	GGGTGCCCAAGGGAGGAGCCGGGAGAGGCCC
GGAGCCGGGAGAGGCCCTCC	AGGGAGGAGCCGGGAGAGGCCCTCCTGGAGG
GCCGGGAGAGGCCCTCCTGG	GAGGAGCCGGGAGAGGCCCTCCTGGAGGTGG
GGGAGAGGCCCTCCTGGAGG	GAGCCGGGAGAGGCCCTCCTGGAGGTGGGCA
GGAGAGGCCCTCCTGGAGGT	AGCCGGGAGAGGCCCTCCTGGAGGTGGGCAC
CCTGGAGGTGGGCACAGCCC	GCCCTCCTGGAGGTGGGCACAGCCCAGGCAA
CCCAGGCAAACATCAGCAGA	CACAGCCCAGGCAAACATCAGCAGACGGAAC
CAGCAGACGGAACCAGCACC	AACATCAGCAGACGGAACCAGCACCCGGGAC
AGCAGACGGAACCAGCACCC	ACATCAGCAGACGGAACCAGCACCCGGGACC
GGAACCAGCACCCGGGACCC	CAGACGGAACCAGCACCCGGGACCCAGGGAA
GAACCAGCACCCGGGACCCA	AGACGGAACCAGCACCCGGGACCCAGGGAAA
GGGAAACGTCACCTGCCACC	ACCCAGGGAAACGTCACCTGCCACCAGGAGC
CCTGCCACCAGGAGCTCCAC	CGTCACCTGCCACCAGGAGCTCCACAGGGTC
CTGCCACCAGGAGCTCCACA	GTCACCTGCCACCAGGAGCTCCACAGGGTCG
GTCGCTGAGCTCCGATTCGA	ACAGGGTCGCTGAGCTCCGATTCGAAGGTGT
TGAGCTCCGATTCGAAGGTG	GTCGCTGAGCTCCGATTCGAAGGTGTGGGGC
GAGCTCCGATTCGAAGGTGT	TCGCTGAGCTCCGATTCGAAGGTGTGGGGCA
AGCTCCGATTCGAAGGTGTG	CGCTGAGCTCCGATTCGAAGGTGTGGGGCAC
TTCGAAGGTGTGGGGCACCC	TCCGATTCGAAGGTGTGGGGCACCCAGGAGC
AGGTGTGGGGCACCCAGGAG	TTCGAAGGTGTGGGGCACCCAGGAGCGGTAG
GGGGCACCCAGGAGCGGTAG	GGTGTGGGGCACCCAGGAGCGGTAGCGGCAC
GTAGCGGCACCTGTAGTTGC	GAGCGGTAGCGGCACCTGTAGTTGCCGGCGT
ACCTGTAGTTGCCGGCGTGC	GCGGCACCTGTAGTTGCCGGCGTGCTGGGGC
CCTGTAGTTGCCGGCGTGCT	CGGCACCTGTAGTTGCCGGCGTGCTGGGGCC
CTGTAGTTGCCGGCGTGCTG	GGCACCTGTAGTTGCCGGCGTGCTGGGGCCC
GCCCCACGAAGATCAGCTCG	CTGGGGCCCCACGAAGATCAGCTCGAGGTTC
GATCAGCTCGAGGTTCGCCG	ACGAAGATCAGCTCGAGGTTCGCCGCGGCCC
CTCGAGGTTCGCCGCGGCCC	ATCAGCTCGAGGTTCGCCGCGGCCCCGGGGG
TCGAGGTTCGCCGCGGCCCC	TCAGCTCGAGGTTCGCCGCGGCCCCGGGGGT
CGAGGTTCGCCGCGGCCCCG	CAGCTCGAGGTTCGCCGCGGCCCCGGGGGTG
GAGGTTCGCCGCGGCCCCGG	AGCTCGAGGTTCGCCGCGGCCCCGGGGGTGC
TCGCCGCGGCCCCGGGGGTG	GAGGTTCGCCGCGGCCCCGGGGGTGCGGACC
GGGGGTGCGGACCGTCTTCA	GCCCCGGGGGTGCGGACCGTCTTCACGGCCT
GCCCTCGCGCAGCAGCTCGA	GTCTCGCCCTCGCGCAGCAGCTCGAAGGTGA
CAGCAGCTCGAAGGTGACGT	TCGCGCAGCAGCTCGAAGGTGACGTCGGGGA
AGCAGCTCGAAGGTGACGTC	CGCGCAGCAGCTCGAAGGTGACGTCGGGGAT
GCAGCTCGAAGGTGACGTCG	GCGCAGCAGCTCGAAGGTGACGTCGGGGATG
CTCGAAGGTGACGTCGGGGA	AGCAGCTCGAAGGTGACGTCGGGGATGGGTC
TCGAAGGTGACGTCGGGGAT	GCAGCTCGAAGGTGACGTCGGGGATGGGTCC
GGATGGGTCCCTCGCAGCGC	GTCGGGGATGGGTCCCTCGCAGCGCAGGACG
GGGTCCCTCGCAGCGCAGGA	GGGATGGGTCCCTCGCAGCGCAGGACGGCAT
CGCAGCGCAGGACGGCATCT	TCCCTCGCAGCGCAGGACGGCATCTCGGCCC
GGACGGCATCTCGGCCCGCC	GCGCAGGACGGCATCTCGGCCCGCCAGGACC
CCGCCCCACTCCACGTCGCC	CAGGACCGCCCCACTCCACGTCGCCCGGAGC
CTCCACGTCGCCCGGAGCTG	CCCCACTCCACGTCGCCCGGAGCTGAGGCCT
CGTCGCCCGGAGCTGAGGCC	CTCCACGTCGCCCGGAGCTGAGGCCTGGGAG
GTCGCCCGGAGCTGAGGCCT	TCCACGTCGCCCGGAGCTGAGGCCTGGGAGG
GCCCGGAGCTGAGGCCTGGG	ACGTCGCCCGGAGCTGAGGCCTGGGAGGGGG
CCCGGAGCTGAGGCCTGGGA	CGTCGCCCGGAGCTGAGGCCTGGGAGGGGGT
CCGGAGCTGAGGCCTGGGAG	GTCGCCCGGAGCTGAGGCCTGGGAGGGGGTC
CGGAGCTGAGGCCTGGGAGG	TCGCCCGGAGCTGAGGCCTGGGAGGGGGTCC
TGAGGCCTGGGAGGGGGTCC	GGAGCTGAGGCCTGGGAGGGGGTCCTGGGCG
GAGGCCTGGGAGGGGGTCCT	GAGCTGAGGCCTGGGAGGGGGTCCTGGGCGG
GCCTGGGAGGGGGTCCTGGG	CTGAGGCCTGGGAGGGGGTCCTGGGCGGAGC
GGAGGGGGTCCTGGGCGGAG	GCCTGGGAGGGGGTCCTGGGCGGAGCGGGCG
GAGGGGGTCCTGGGCGGAGC	CCTGGGAGGGGGTCCTGGGCGGAGCGGGCGG
GGGGTCCTGGGCGGAGCGGG	GGGAGGGGGTCCTGGGCGGAGCGGGCGGGTG
GGGTCCTGGGCGGAGCGGGC	GGAGGGGGTCCTGGGCGGAGCGGGCGGGTGG
TCCTGGGCGGAGCGGGCGGG	GGGGGTCCTGGGCGGAGCGGGCGGGTGGTCG
GGGCGGAGCGGGCGGGTGGT	GTCCTGGGCGGAGCGGGCGGGTGGTCGGGCC
GGCGGAGCGGGCGGGTGGTC	TCCTGGGCGGAGCGGGCGGGTGGTCGGGCCA
AGCGGGCGGGTGGTCGGGCC	GGCGGAGCGGGCGGGTGGTCGGGCCAGGCCA
GTCGGGCCAGGCCACGCCCC	GGGTGGTCGGGCCAGGCCACGCCCCAGGCCA
CACGCCCCAGGCCACGCCCC	CAGGCCACGCCCCAGGCCACGCCCCAGGCCA
CACGCCCCAGGCCACACCCC	CAGGCCACGCCCCAGGCCACACCCCAGGCCA
CACACCCCAGGCCACACCCC	CAGGCCACACCCCAGGCCACACCCCAGGCCG
CCGCGCCTGCGCCTCAGCCC	CGCGCCCGCGCCTGCGCCTCAGCCCCGGCTT
CATCTTCCCTGTCTTGTTCC	GGCTTCATCTTCCCTGTCTTGTTCCTGGGCG
ATCTTCCCTGTCTTGTTCCT	GCTTCATCTTCCCTGTCTTGTTCCTGGGCGC
TGTCTTGTTCCTGGGCGCAG	TTCCCTGTCTTGTTCCTGGGCGCAGAGGGCT
GTCTTGTTCCTGGGCGCAGA	TCCCTGTCTTGTTCCTGGGCGCAGAGGGCTC
CTGGGCGCAGAGGGCTCCTC	TGTTCCTGGGCGCAGAGGGCTCCTCCGGCGC
CGCCCGCTGCCTTCACACCC	AGCTGCGCCCGCTGCCTTCACACCCCGGACA
TGTCCCCGCACCCCTCCCCC	GTGAGTGTCCCCGCACCCCTCCCCCAGGACC
GCACCCCTCCCCCAGGACCG	TCCCCGCACCCCTCCCCCAGGACCGTGGAAG
GACCGTGGAAGTCCCAGATT	CCCAGGACCGTGGAAGTCCCAGATTCGGGCC
ACCGTGGAAGTCCCAGATTC	CCAGGACCGTGGAAGTCCCAGATTCGGGCCT
TCCCAGATTCGGGCCTGCTC	GGAAGTCCCAGATTCGGGCCTGCTCTGGGGC
CCCAGATTCGGGCCTGCTCT	GAAGTCCCAGATTCGGGCCTGCTCTGGGGCT
CCAGATTCGGGCCTGCTCTG	AAGTCCCAGATTCGGGCCTGCTCTGGGGCTT
CGGGCCTGCTCTGGGGCTTC	AGATTCGGGCCTGCTCTGGGGCTTCTGGGGT
GGGCCTGCTCTGGGGCTTCT	GATTCGGGCCTGCTCTGGGGCTTCTGGGGTC
GGCCTGCTCTGGGGCTTCTG	ATTCGGGCCTGCTCTGGGGCTTCTGGGGTCC
GCTTCTGGGGTCCCCAGCCT	CTGGGGCTTCTGGGGTCCCCAGCCTCGGTCA
CCCAGCCTCGGTCACTCTGA	GGGTCCCCAGCCTCGGTCACTCTGACGGGTG
CCAGCCTCGGTCACTCTGAC	GGTCCCCAGCCTCGGTCACTCTGACGGGTGA
TCGGTCACTCTGACGGGTGA	CAGCCTCGGTCACTCTGACGGGTGAAGGGAA
CGGTCACTCTGACGGGTGAA	AGCCTCGGTCACTCTGACGGGTGAAGGGAAG
GTGAAGGGAAGAAGAAATGA	GACGGGTGAAGGGAAGAAGAAATGATGGAGA
AGAAGAAATGATGGAGAAAA	AGGGAAGAAGAAATGATGGAGAAAACGGTGC
GAGAAAACGGTGCTCCTTCA	TGATGGAGAAAACGGTGCTCCTTCATGGAGG
AAAACGGTGCTCCTTCATGG	TGGAGAAAACGGTGCTCCTTCATGGAGGGAC
AAACGGTGCTCCTTCATGGA	GGAGAAAACGGTGCTCCTTCATGGAGGGACC
CTTCATGGAGGGACCAAAAA	TGCTCCTTCATGGAGGGACCAAAAAAGGACA
ACAATCTATGTCAATAGATG	GACATACAATCTATGTCAATAGATGAGGGTT
CAATCTATGTCAATAGATGA	ACATACAATCTATGTCAATAGATGAGGGTTT
TAACTTTAAAAGTGTATTTA	AAGTTTAACTTTAAAAGTGTATTTAAGGTGC
TAAAAGTGTATTTAAGGTGC	AACTTTAAAAGTGTATTTAAGGTGCCGGGCG
AAAAGTGTATTTAAGGTGCC	ACTTTAAAAGTGTATTTAAGGTGCCGGGCGC
ATTTAAGGTGCCGGGCGCAG	AGTGTATTTAAGGTGCCGGGCGCAGTGGCTC
TGTAATCTCAGCACTTTGAG	ACACCTGTAATCTCAGCACTTTGAGAGGCCG
CTCAGCACTTTGAGAGGCCG	GTAATCTCAGCACTTTGAGAGGCCGAGGCAG
GCACTTTGAGAGGCCGAGGC	TCTCAGCACTTTGAGAGGCCGAGGCAGGCGG
CTTTGAGAGGCCGAGGCAGG	CAGCACTTTGAGAGGCCGAGGCAGGCGGATT
CAGGCGGATTGCCTGAGCTC	CGAGGCAGGCGGATTGCCTGAGCTCAGGAGT
TCAGGAGTTCCAGACCAGCC	TGAGCTCAGGAGTTCCAGACCAGCCTGGGTA
CAGGAGTTCCAGACCAGCCT	GAGCTCAGGAGTTCCAGACCAGCCTGGGTAA
CCAGACCAGCCTGGGTAACA	GAGTTCCAGACCAGCCTGGGTAACACGGTGA
CTAAAATACAAAAAATTAGC	CTCTACTAAAATACAAAAAATTAGCCGGGCG
TAAAATACAAAAAATTAGCC	TCTACTAAAATACAAAAAATTAGCCGGGCGT
TACAAAAAATTAGCCGGGCG	TAAAATACAAAAAATTAGCCGGGCGTGGCAG
CGCCTGTAATCCCAGCTACT	GCGTGCGCCTGTAATCCCAGCTACTCGGGAG
GCCTGTAATCCCAGCTACTC	CGTGCGCCTGTAATCCCAGCTACTCGGGAGG
TGTAATCCCAGCTACTCGGG	GCGCCTGTAATCCCAGCTACTCGGGAGGTGG
AATCCCAGCTACTCGGGAGG	CCTGTAATCCCAGCTACTCGGGAGGTGGAGG
CCCAGCTACTCGGGAGGTGG	GTAATCCCAGCTACTCGGGAGGTGGAGGCAG
GCTACTCGGGAGGTGGAGGC	TCCCAGCTACTCGGGAGGTGGAGGCAGGAAA
GCAGGAAAATTGCTTGAACC	TGGAGGCAGGAAAATTGCTTGAACCTGGGAG
CAGGAAAATTGCTTGAACCT	GGAGGCAGGAAAATTGCTTGAACCTGGGAGG
GAAAATTGCTTGAACCTGGG	GGCAGGAAAATTGCTTGAACCTGGGAGGCAG
TGCTTGAACCTGGGAGGCAG	AAAATTGCTTGAACCTGGGAGGCAGAGGTTT
TGCGCCACTGCACTCCAGCC	AAGATTGCGCCACTGCACTCCAGCCCGGGTG
GCGCCACTGCACTCCAGCCC	AGATTGCGCCACTGCACTCCAGCCCGGGTGA
ACAAACAAAACAAAACTGTA	AACAAACAAACAAAACAAAACTGTAAGGAAT
AATCAAATGTTACAAAATCC	TAAGGAATCAAATGTTACAAAATCCTGGAAG
TACAAAATCCTGGAAGATTT	AATGTTACAAAATCCTGGAAGATTTTGGTAA
GTAATGCTGTTGATAATTTC	TTTTGGTAATGCTGTTGATAATTTCAGGGAA
TAATGCTGTTGATAATTTCA	TTTGGTAATGCTGTTGATAATTTCAGGGAAA
ATAGTTTGAGTATCTTGCCA	ATTCAATAGTTTGAGTATCTTGCCATGGAAG
CAATTAATTGTAAGCTAATC	ATTTGCAATTAATTGTAAGCTAATCAGGAAT
AGGAATTTTGAAAGCTTGAT	TAATCAGGAATTTTGAAAGCTTGATTGGATT
CAAACTATAATGTTGAAATT	ATTAACAAACTATAATGTTGAAATTTGGTAA
TTTAATTTTGTGTCTTAGTG	CCTAGTTTAATTTTGTGTCTTAGTGTGGATT
ACTACAGTTATTCTGAGCCC	AATTTACTACAGTTATTCTGAGCCCAGGAAC
CAGGAACCCAATCAGATTTC	GAGCCCAGGAACCCAATCAGATTTCAGGCCA
ATTTCAGGCCAGTTTGATAC	ATCAGATTTCAGGCCAGTTTGATACTGGCTG
TGGCTGTTCTTAATTCTAAC	GATACTGGCTGTTCTTAATTCTAACAGGAGA
CTTAATTCTAACAGGAGAGT	CTGTTCTTAATTCTAACAGGAGAGTAGGACA
CATACTAAATGTTATGTCAG	GACATCATACTAAATGTTATGTCAGTGGGAC
ATACTAAATGTTATGTCAGT	ACATCATACTAAATGTTATGTCAGTGGGACT
CAGTGGGACTGTGTTGTCTT	TATGTCAGTGGGACTGTGTTGTCTTTGGAGC
ATCATTTTCTTCAGACTTTA	AATTAATCATTTTCTTCAGACTTTAAGGAGA
GGAGAGTGATAAATAAAATT	TTTAAGGAGAGTGATAAATAAAATTTGGAGT
TAAATAAAATTTGGAGTCAT	AGTGATAAATAAAATTTGGAGTCATAGGATA
CATTTTTTTTTTTTTTGAGA	TTAAACATTTTTTTTTTTTTTGAGATGGAGT
GAGTTTTGCTCTTGTTGCCC	AGATGGAGTTTTGCTCTTGTTGCCCAGGCTG
TTTGCTCTTGTTGCCCAGGC	GGAGTTTTGCTCTTGTTGCCCAGGCTGGAAT
TTGCCCAGGCTGGAATGCAG	TCTTGTTGCCCAGGCTGGAATGCAGTGGCAT
TGGAATGCAGTGGCATGACC	CAGGCTGGAATGCAGTGGCATGACCTGGACT
TCACTGCAAACTCCACCTCC	TGGACTCACTGCAAACTCCACCTCCCGGGTT
CACTGCAAACTCCACCTCCC	GGACTCACTGCAAACTCCACCTCCCGGGTTA
TCCTGCCTCAGCCTCCCAAG	AATTCTCCTGCCTCAGCCTCCCAAGTGGCTG
GCCTCAGCCTCCCAAGTGGC	CTCCTGCCTCAGCCTCCCAAGTGGCTGGGAT
CCTCAGCCTCCCAAGTGGCT	TCCTGCCTCAGCCTCCCAAGTGGCTGGGATT
TCCCAAGTGGCTGGGATTAC	CAGCCTCCCAAGTGGCTGGGATTACAGGCAT
CAGGCATGTGCCACCACAGC	GATTACAGGCATGTGCCACCACAGCTGGCTA
TTTGTATTTTTAGTAGAGAC	CTAATTTTGTATTTTTAGTAGAGACAGGGTT
TTGTATTTTTAGTAGAGACA	TAATTTTGTATTTTTAGTAGAGACAGGGTTT
GAGACAGGGTTTCTCCATGT	TAGTAGAGACAGGGTTTCTCCATGTTGGCCA
AGGGTTTCTCCATGTTGGCC	GAGACAGGGTTTCTCCATGTTGGCCAGGCTG
ATTTTGTGATCCACCCGCCT	TCCTGATTTTGTGATCCACCCGCCTTGGCCT
TCCCAAAGTGCTGTGATTAC	TGGCCTCCCAAAGTGCTGTGATTACAGGCGT
CAGGCGTGAGCCACCTTGCC	GATTACAGGCGTGAGCCACCTTGCCTGGCCA
TAAACATTTTTCATCAATTG	AAGATTAAACATTTTTCATCAATTGTGGATG
CATTTTTCATCAATTGTGGA	TTAAACATTTTTCATCAATTGTGGATGGTGG
TTTTCATCAATTGTGGATGG	AACATTTTTCATCAATTGTGGATGGTGGCTT
GCTTATAACACTGCAAGAAT	TGGTGGCTTATAACACTGCAAGAATAGGCTG
ATAACACTGCAAGAATAGGC	GGCTTATAACACTGCAAGAATAGGCTGGGCA
TAACACTGCAAGAATAGGCT	GCTTATAACACTGCAAGAATAGGCTGGGCAT
CTGCAAGAATAGGCTGGGCA	TAACACTGCAAGAATAGGCTGGGCATGGTGA
CAAGTGTAATCCCAGCACTT	ACTCACAAGTGTAATCCCAGCACTTTGGGAG
AAGTGTAATCCCAGCACTTT	CTCACAAGTGTAATCCCAGCACTTTGGGAGG
TGTAATCCCAGCACTTTGGG	ACAAGTGTAATCCCAGCACTTTGGGAGGCAG
CCCAGCACTTTGGGAGGCAG	GTAATCCCAGCACTTTGGGAGGCAGAGGCGG
AGCACTTTGGGAGGCAGAGG	ATCCCAGCACTTTGGGAGGCAGAGGCGGGCA
GCACTTTGGGAGGCAGAGGC	TCCCAGCACTTTGGGAGGCAGAGGCGGGCAG
GCAGAGGCGGGCAGATCACA	GGGAGGCAGAGGCGGGCAGATCACAAGGTCA
GGCGGGCAGATCACAAGGTC	GCAGAGGCGGGCAGATCACAAGGTCAGGAGG
GGGCAGATCACAAGGTCAGG	GAGGCGGGCAGATCACAAGGTCAGGAGGTCA
CCAGCCAACATAGCAAAACC	CCAGCCCAGCCAACATAGCAAAACCCGGTCT
CTACTAAAAATACGAAAATT	GGTCTCTACTAAAAATACGAAAATTAGGTGG
CTAAAAATACGAAAATTAGG	CTCTACTAAAAATACGAAAATTAGGTGGGCA
TAAAAATACGAAAATTAGGT	TCTACTAAAAATACGAAAATTAGGTGGGCAT
ATACGAAAATTAGGTGGGCA	TAAAAATACGAAAATTAGGTGGGCATGGTGG
CGAAAATTAGGTGGGCATGG	AAATACGAAAATTAGGTGGGCATGGTGGCAT
GCCTCTAATACCAGCTACTC	CATGCGCCTCTAATACCAGCTACTCAGGAGG
TCTAATACCAGCTACTCAGG	GCGCCTCTAATACCAGCTACTCAGGAGGCTG
ACCAGCTACTCAGGAGGCTG	CTAATACCAGCTACTCAGGAGGCTGAGGCAG
GCTACTCAGGAGGCTGAGGC	TACCAGCTACTCAGGAGGCTGAGGCAGGAGA
GAGAACTGCCTGAACCCAGA	GGCAGGAGAACTGCCTGAACCCAGAAGGCGA
GAGACTGCACCACTGCACTC	GAGCTGAGACTGCACCACTGCACTCCGGCCT
TATCCAAAAAAAAAACAAAA	TAAGTTATCCAAAAAAAAAACAAAAAGGAGA
AAAACAAAAAGGAGAAGAAA	AAAAAAAAACAAAAAGGAGAAGAAAAGGGAG
AAACAAAAAGGAGAAGAAAA	AAAAAAAACAAAAAGGAGAAGAAAAGGGAGG
CAAAAAGGAGAAGAAAAGGG	AAAAACAAAAAGGAGAAGAAAAGGGAGGAAT
AGAAGAAAAGGGAGGAATGA	AAAGGAGAAGAAAAGGGAGGAATGAAGGAGA
GGAGGAATGAAGGAGAGAGA	AAAAGGGAGGAATGAAGGAGAGAGATGGGGT
GAGGAATGAAGGAGAGAGAT	AAAGGGAGGAATGAAGGAGAGAGATGGGGTT
AGGAATGAAGGAGAGAGATG	AAGGGAGGAATGAAGGAGAGAGATGGGGTTG
ATGAAGGAGAGAGATGGGGT	GAGGAATGAAGGAGAGAGATGGGGTTGGGGG
TGAAGGAGAGAGATGGGGTT	AGGAATGAAGGAGAGAGATGGGGTTGGGGGG
GAAGGAGAGAGATGGGGTTG	GGAATGAAGGAGAGAGATGGGGTTGGGGGGC
AAGGAGAGAGATGGGGTTGG	GAATGAAGGAGAGAGATGGGGTTGGGGGGCA
AGGAGAGAGATGGGGTTGGG	AATGAAGGAGAGAGATGGGGTTGGGGGGCAG
AGAAAGAAAAGAGAGAAAGA	AAAGAAGAAAGAAAAGAGAGAAAGAAGGAAG
AGAAAAGAGAGAAAGAAGGA	AAGAAAGAAAAGAGAGAAAGAAGGAAGGAAG
AAGGAAGGAAGAAAGAAAGA	GAAAGAAGGAAGGAAGAAAGAAAGAAGGAAA
GGAAAGAGAAAGAAAGAAAG	AAGAAGGAAAGAGAAAGAAAGAAAGAGGAAG
AGAGAAAGAAAGAAAGAGGA	AGGAAAGAGAAAGAAAGAAAGAGGAAGGAAG
AAAGAAAGAAAGAGGAAGGA	AAGAGAAAGAAAGAAAGAGGAAGGAAGGCAG
AAAGAAAGAGGAAGGAAGGC	GAAAGAAAGAAAGAGGAAGGAAGGCAGGAAA
AAGTGAAAGAAAAGAGAAAA	AAAGAAAGTGAAAGAAAAGAGAAAACGGTGC
GAAAACGGTGCTCCCAGCAA	AAAGAGAAAACGGTGCTCCCAGCAAAGGGTA
AAAACGGTGCTCCCAGCAAA	AAGAGAAAACGGTGCTCCCAGCAAAGGGTAC
AAGGGTACGACCTCAAGATC	CAGCAAAGGGTACGACCTCAAGATCTGGAGG
GGTACGACCTCAAGATCTGG	CAAAGGGTACGACCTCAAGATCTGGAGGTCA
CCTGTGCCCTCACGCTCTGC	TCAGACCTGTGCCCTCACGCTCTGCTGGGCT
CTGTGCCCTCACGCTCTGCT	CAGACCTGTGCCCTCACGCTCTGCTGGGCTC
CTCTGCTGGGCTCTGAGTCC	TCACGCTCTGCTGGGCTCTGAGTCCTGGAGA
GAGTCCTGGAGACGTCGATG	GCTCTGAGTCCTGGAGACGTCGATGAGGAAA
GACGTCGATGAGGAAATCAG	CTGGAGACGTCGATGAGGAAATCAGAGGGAC
ACGTCGATGAGGAAATCAGA	TGGAGACGTCGATGAGGAAATCAGAGGGACA
ATCAGAGGGACAAACAGAGC	AGGAAATCAGAGGGACAAACAGAGCTGGGGA
TCAGAGGGACAAACAGAGCT	GGAAATCAGAGGGACAAACAGAGCTGGGGAC
CAGAGGGACAAACAGAGCTG	GAAATCAGAGGGACAAACAGAGCTGGGGACG
GGGACAAACAGAGCTGGGGA	TCAGAGGGACAAACAGAGCTGGGGACGGCGG
ACAAACAGAGCTGGGGACGG	GAGGGACAAACAGAGCTGGGGACGGCGGGGA
CAAACAGAGCTGGGGACGGC	AGGGACAAACAGAGCTGGGGACGGCGGGGAT
AAACAGAGCTGGGGACGGCG	GGGACAAACAGAGCTGGGGACGGCGGGGATG
AGAGCTGGGGACGGCGGGGA	CAAACAGAGCTGGGGACGGCGGGGATGGGGA
GAGCTGGGGACGGCGGGGAT	AAACAGAGCTGGGGACGGCGGGGATGGGGAG
AGCTGGGGACGGCGGGGATG	AACAGAGCTGGGGACGGCGGGGATGGGGAGA
GGACGGCGGGGATGGGGAGA	GCTGGGGACGGCGGGGATGGGGAGAAGGACA
ACACATCAGCCGTGCGCCTG	GAAGGACACATCAGCCGTGCGCCTGCGGGAC
CACATCAGCCGTGCGCCTGC	AAGGACACATCAGCCGTGCGCCTGCGGGACC
CAGCCGTGCGCCTGCGGGAC	CACATCAGCCGTGCGCCTGCGGGACCGGGGC
AGCCGTGCGCCTGCGGGACC	ACATCAGCCGTGCGCCTGCGGGACCGGGGCC
GCCGTGCGCCTGCGGGACCG	CATCAGCCGTGCGCCTGCGGGACCGGGGCCG
TGCGCCTGCGGGACCGGGGC	AGCCGTGCGCCTGCGGGACCGGGGCCGGGGC
GCGCCTGCGGGACCGGGGCC	GCCGTGCGCCTGCGGGACCGGGGCCGGGGCG
CGCCTGCGGGACCGGGGCCG	CCGTGCGCCTGCGGGACCGGGGCCGGGGCGG
CTGCGGGACCGGGGCCGGGG	TGCGCCTGCGGGACCGGGGCCGGGGCGGGGG
TGCGGGACCGGGGCCGGGGC	GCGCCTGCGGGACCGGGGCCGGGGCGGGGGG
GCGGGACCGGGGCCGGGGCG	CGCCTGCGGGACCGGGGCCGGGGCGGGGGGT
CGGGACCGGGGCCGGGGCGG	GCCTGCGGGACCGGGGCCGGGGCGGGGGGTC
GGGACCGGGGCCGGGGCGGG	CCTGCGGGACCGGGGCCGGGGCGGGGGGTCC
GTCCAGTATGACGACTGACA	GGGGGGTCCAGTATGACGACTGACATGGCCA
ACATGGCCAGTAATAAAACA	GACTGACATGGCCAGTAATAAAACAAGGCAG
CAAGGCAGCCACAGAGCTGC	TAAAACAAGGCAGCCACAGAGCTGCAGGGAT
AAGGCAGCCACAGAGCTGCA	AAAACAAGGCAGCCACAGAGCTGCAGGGATC
GGGATCTGAACAAGAAAACC	CTGCAGGGATCTGAACAAGAAAACCTGGGGC
GGATCTGAACAAGAAAACCT	TGCAGGGATCTGAACAAGAAAACCTGGGGCC
GATCTGAACAAGAAAACCTG	GCAGGGATCTGAACAAGAAAACCTGGGGCCA
ACCACGCTACACGTGACCTA	CGACCACCACGCTACACGTGACCTACGGGCT
CCACGCTACACGTGACCTAC	GACCACCACGCTACACGTGACCTACGGGCTT
GACCTACGGGCTTGCGTCCG	CACGTGACCTACGGGCTTGCGTCCGTGGGAA
ACCTACGGGCTTGCGTCCGT	ACGTGACCTACGGGCTTGCGTCCGTGGGAAA
GGGAAATAAGCCGAAATTCC	TCCGTGGGAAATAAGCCGAAATTCCAGGCGT
ACCGATCGCCTGCTCCCCGC	CGACCACCGATCGCCTGCTCCCCGCCGGGGT
CCGATCGCCTGCTCCCCGCC	GACCACCGATCGCCTGCTCCCCGCCGGGGTA
CGATCGCCTGCTCCCCGCCG	ACCACCGATCGCCTGCTCCCCGCCGGGGTAG
CGCCTGCTCCCCGCCGGGGT	CCGATCGCCTGCTCCCCGCCGGGGTAGGCGA
CTCCCCGCCGGGGTAGGCGA	GCCTGCTCCCCGCCGGGGTAGGCGATGGGGG
TCCCCGCCGGGGTAGGCGAT	CCTGCTCCCCGCCGGGGTAGGCGATGGGGGC
CCCCGCCGGGGTAGGCGATG	CTGCTCCCCGCCGGGGTAGGCGATGGGGGCT
CCCGCCGGGGTAGGCGATGG	TGCTCCCCGCCGGGGTAGGCGATGGGGGCTG
AGGCGATGGGGGCTGAACCA	GGGGTAGGCGATGGGGGCTGAACCAAGGCCC
AAGGCCCAGAGCGCCGCCGT	GAACCAAGGCCCAGAGCGCCGCCGTCGGACG
GCGCCGCCGTCGGACGCCCA	CCAGAGCGCCGCCGTCGGACGCCCAAGGAAA
CGTCGGACGCCCAAGGAAAG	GCCGCCGTCGGACGCCCAAGGAAAGAGGGGA
GTCGGACGCCCAAGGAAAGA	CCGCCGTCGGACGCCCAAGGAAAGAGGGGAA
TCGGACGCCCAAGGAAAGAG	CGCCGTCGGACGCCCAAGGAAAGAGGGGAAA
CAAGGAAAGAGGGGAAAGAC	ACGCCCAAGGAAAGAGGGGAAAGACAGGAGG
GGAAAGAGGGGAAAGACAGG	CCCAAGGAAAGAGGGGAAAGACAGGAGGCCC
GGGAAAGACAGGAGGCCCCG	AAGAGGGGAAAGACAGGAGGCCCCGAGGGGC
GGAAAGACAGGAGGCCCCGA	AGAGGGGAAAGACAGGAGGCCCCGAGGGGCA
GAAAGACAGGAGGCCCCGAG	GAGGGGAAAGACAGGAGGCCCCGAGGGGCAC
GAACCCGCGCCCGCCCTCGC	GCACTGAACCCGCGCCCGCCCTCGCTGGTGC
GTGCAGCTCCAAGCGCTCGC	TCCACGTGCAGCTCCAAGCGCTCGCTGGGCG
TGCAGCTCCAAGCGCTCGCT	CCACGTGCAGCTCCAAGCGCTCGCTGGGCGC
CTCCAAGCGCTCGCTGGGCG	TGCAGCTCCAAGCGCTCGCTGGGCGCGGAGC
CTGGGCGCGGAGCCCCCGAA	GCTCGCTGGGCGCGGAGCCCCCGAAAGGCGG
GGCGCGGAGCCCCCGAAAGG	CGCTGGGCGCGGAGCCCCCGAAAGGCGGCTT
AGCCCCCGAAAGGCGGCTTC	CGCGGAGCCCCCGAAAGGCGGCTTCAGGTCC
CACGTAGACGCAGCTGTAGT	AGGTCCACGTAGACGCAGCTGTAGTTGGCGG
GTAGACGCAGCTGTAGTTGG	TCCACGTAGACGCAGCTGTAGTTGGCGGAGT
GTAGTTGGCGGAGTCAGCCA	CAGCTGTAGTTGGCGGAGTCAGCCACGGAAA
GTGCAGCTCGAAGAGCGCCT	ATGTTGTGCAGCTCGAAGAGCGCCTCGGTCC
GAAGAGCGCCTCGGTCCCAG	AGCTCGAAGAGCGCCTCGGTCCCAGCGGGGC
AAGAGCGCCTCGGTCCCAGC	GCTCGAAGAGCGCCTCGGTCCCAGCGGGGCT
AGAGCGCCTCGGTCCCAGCG	CTCGAAGAGCGCCTCGGTCCCAGCGGGGCTC
CCTCGGTCCCAGCGGGGCTC	GAGCGCCTCGGTCCCAGCGGGGCTCTGGAAA
TCCCAGCGGGGCTCTGGAAA	CTCGGTCCCAGCGGGGCTCTGGAAACGGTGC
GGCTCTGGAAACGGTGCACG	AGCGGGGCTCTGGAAACGGTGCACGCGGCGC
CGCCCCTGTCCTCGCGCACC	GCGCCCGCCCCTGTCCTCGCGCACCAGGGCG
GCCCCTGTCCTCGCGCACCA	CGCCCGCCCCTGTCCTCGCGCACCAGGGCGA
GGGCGAAGCGCGCGCCCTCC	CACCAGGGCGAAGCGCGCGCCCTCCAGGGGC
GGCGAAGCGCGCGCCCTCCA	ACCAGGGCGAAGCGCGCGCCCTCCAGGGGCG
GCGAAGCGCGCGCCCTCCAG	CCAGGGCGAAGCGCGCGCCCTCCAGGGGCGC
GCGCGCCCTCCAGGGGCGCC	GAAGCGCGCGCCCTCCAGGGGCGCCAGGCAC
CGCCAGGCACCGCAGCCGCA	AGGGGCGCCAGGCACCGCAGCCGCAAGGCCC
CCGCAGCCGCAAGGCCCTGC	AGGCACCGCAGCCGCAAGGCCCTGCCGGACT
CGCAAGGCCCTGCCGGACTC	GCAGCCGCAAGGCCCTGCCGGACTCCGGCTC
GCCCTGCCGGACTCCGGCTC	GCAAGGCCCTGCCGGACTCCGGCTCCGGGGA
CCCTGCCGGACTCCGGCTCC	CAAGGCCCTGCCGGACTCCGGCTCCGGGGAG
CCTGCCGGACTCCGGCTCCG	AAGGCCCTGCCGGACTCCGGCTCCGGGGAGA
TCCGGCTCCGGGGAGAACTC	CGGACTCCGGCTCCGGGGAGAACTCCGGCGC
CTCCGGGGAGAACTCCGGCG	TCCGGCTCCGGGGAGAACTCCGGCGCGGGCA
TCCGGGGAGAACTCCGGCGC	CCGGCTCCGGGGAGAACTCCGGCGCGGGCAG
CGGCGCGGGCAGCGTCTCTG	AACTCCGGCGCGGGCAGCGTCTCTGCGGAGC
CGTCTCTGCGGAGCAGCACA	GGCAGCGTCTCTGCGGAGCAGCACACGGGCT
GTCTCTGCGGAGCAGCACAC	GCAGCGTCTCTGCGGAGCAGCACACGGGCTG
GAGCAGCACACGGGCTGACC	CTGCGGAGCAGCACACGGGCTGACCCGGGCG
AGCAGCACACGGGCTGACCC	TGCGGAGCAGCACACGGGCTGACCCGGGCGC
GGGCTGACCCGGGCGCCCAG	CACACGGGCTGACCCGGGCGCCCAGCGGCTG
TGACCCGGGCGCCCAGCGGC	CGGGCTGACCCGGGCGCCCAGCGGCTGGCTC
CGGGCGCCCAGCGGCTGGCT	TGACCCGGGCGCCCAGCGGCTGGCTCGGCCC
GCTGGCTCGGCCCTAACGCG	CAGCGGCTGGCTCGGCCCTAACGCGTGGTCT
CTCGGCCCTAACGCGTGGTC	GCTGGCTCGGCCCTAACGCGTGGTCTGGCCT
TGGCCTCGCGCTCTTTGCCT	TGGTCTGGCCTCGCGCTCTTTGCCTTGGCTG
GTCTTCTGCCCGCAATGACC	GCTGAGTCTTCTGCCCGCAATGACCTGGCCA
GCTTCCTCCCTCGCCTCCTC	GGCCAGCTTCCTCCCTCGCCTCCTCCGGGCC
CTTCCTCCCTCGCCTCCTCC	GCCAGCTTCCTCCCTCGCCTCCTCCGGGCCC
CACCTTTGCATCCCAGTCCT	CGCCCCACCTTTGCATCCCAGTCCTTGGATA
TGTTTGTCTACAGACACAGA	TAATTTGTTTGTCTACAGACACAGACGGGAA
GTTTGTCTACAGACACAGAC	AATTTGTTTGTCTACAGACACAGACGGGAAG
CTACAGACACAGACGGGAAG	TTTGTCTACAGACACAGACGGGAAGCGGGGA
TACAGACACAGACGGGAAGC	TTGTCTACAGACACAGACGGGAAGCGGGGAC
ACAGACACAGACGGGAAGCG	TGTCTACAGACACAGACGGGAAGCGGGGACG
ACACAGACGGGAAGCGGGGA	TACAGACACAGACGGGAAGCGGGGACGGGGA
CACAGACGGGAAGCGGGGAC	ACAGACACAGACGGGAAGCGGGGACGGGGAC
ACAGACGGGAAGCGGGGACG	CAGACACAGACGGGAAGCGGGGACGGGGACA
ACGGGGACATGTTTTGTGCA	CGGGGACGGGGACATGTTTTGTGCATGGCTT
TTTGTGCATGGCTTGATGCC	CATGTTTTGTGCATGGCTTGATGCCTGGTGC
TGCACGATGCCGCTCAGTAG	CCTGGTGCACGATGCCGCTCAGTAGTGGATT
CCGCCCCAATGCCCGCCCCA	GAGCACCGCCCCAATGCCCGCCCCACGGAGG
CCCCAATGCCCGCCCCACGG	CACCGCCCCAATGCCCGCCCCACGGAGGGGC
CCCAATGCCCGCCCCACGGA	ACCGCCCCAATGCCCGCCCCACGGAGGGGCC
CCAATGCCCGCCCCACGGAG	CCGCCCCAATGCCCGCCCCACGGAGGGGCCC
GCCCCACGGAGGGGCCCCTG	TGCCCGCCCCACGGAGGGGCCCCTGTGGTCC
GAGGGGCCCCTGTGGTCCGC	CCACGGAGGGGCCCCTGTGGTCCGCTGGGCA
AGGGGCCCCTGTGGTCCGCT	CACGGAGGGGCCCCTGTGGTCCGCTGGGCAT
CCCCTGTGGTCCGCTGGGCA	AGGGGCCCCTGTGGTCCGCTGGGCATGGGGT
CCCTGTGGTCCGCTGGGCAT	GGGGCCCCTGTGGTCCGCTGGGCATGGGGTT
CCTGTGGTCCGCTGGGCATG	GGGCCCCTGTGGTCCGCTGGGCATGGGGTTC
TGGGCATGGGGTTCGCTGTC	TCCGCTGGGCATGGGGTTCGCTGTCCGGTGC
AGAGTTTGCTAAATACCATC	TGCTCAGAGTTTGCTAAATACCATCAGGTCC
GCTAAATACCATCAGGTCCA	AGTTTGCTAAATACCATCAGGTCCAAGGCAA
TCAGGTCCAAGGCAAGCGAG	TACCATCAGGTCCAAGGCAAGCGAGCGGAGG
GGTCCAAGGCAAGCGAGCGG	CATCAGGTCCAAGGCAAGCGAGCGGAGGAGC
CGGAGGAGCTGCCTCAGCAG	GCGAGCGGAGGAGCTGCCTCAGCAGAGGCCC
CCTCAGTGCTCACCTAGACC	GAGGCCCTCAGTGCTCACCTAGACCTGGCAG
GCTCACCTAGACCTGGCAGC	TCAGTGCTCACCTAGACCTGGCAGCTGGGAT
CTCACCTAGACCTGGCAGCT	CAGTGCTCACCTAGACCTGGCAGCTGGGATG
CCTAGACCTGGCAGCTGGGA	GCTCACCTAGACCTGGCAGCTGGGATGGGAC
CTAGACCTGGCAGCTGGGAT	CTCACCTAGACCTGGCAGCTGGGATGGGACC
CAGCTGGGATGGGACCTGCC	CCTGGCAGCTGGGATGGGACCTGCCAGGTGG
CTGGGATGGGACCTGCCAGG	GGCAGCTGGGATGGGACCTGCCAGGTGGTGC
CTGCCAGGTGGTGCCCCCTG	GGGACCTGCCAGGTGGTGCCCCCTGTGGCCT
AGGTGGTGCCCCCTGTGGCC	CTGCCAGGTGGTGCCCCCTGTGGCCTGGGCC
GGTGGTGCCCCCTGTGGCCT	TGCCAGGTGGTGCCCCCTGTGGCCTGGGCCA
GTTCACCCAGTTATTCCCTG	GACCTGTTCACCCAGTTATTCCCTGTGGGGC
TTCACCCAGTTATTCCCTGT	ACCTGTTCACCCAGTTATTCCCTGTGGGGCC
TCACCCAGTTATTCCCTGTG	CCTGTTCACCCAGTTATTCCCTGTGGGGCCT
TTATTCCCTGTGGGGCCTGA	CCCAGTTATTCCCTGTGGGGCCTGAAGGTTG
CATCATCATATTTGCAGTTT	ACGCTCATCATCATATTTGCAGTTTAGGACC
TGCAGTTTAGGACCCTGAAT	ATATTTGCAGTTTAGGACCCTGAATCGGCGG
AGTTTAGGACCCTGAATCGG	TTTGCAGTTTAGGACCCTGAATCGGCGGGTG
GTTTAGGACCCTGAATCGGC	TTGCAGTTTAGGACCCTGAATCGGCGGGTGG
TAGGACCCTGAATCGGCGGG	CAGTTTAGGACCCTGAATCGGCGGGTGGGCG
AGGACCCTGAATCGGCGGGT	AGTTTAGGACCCTGAATCGGCGGGTGGGCGG
ACCCTGAATCGGCGGGTGGG	TTAGGACCCTGAATCGGCGGGTGGGCGGATA
GGCGGGTGGGCGGATAAAGT	GAATCGGCGGGTGGGCGGATAAAGTTGGTAT
TGGGCGGATAAAGTTGGTAT	GCGGGTGGGCGGATAAAGTTGGTATTGGACC
ATAAAGTTGGTATTGGACCC	GGCGGATAAAGTTGGTATTGGACCCTGGCCC
ACTTCCCCAGACTCTACACC	ACTGCACTTCCCCAGACTCTACACCTGGTAC
TGGTACTGCTCCTGCTCCCC	ACACCTGGTACTGCTCCTGCTCCCCAGGGAC
GGTACTGCTCCTGCTCCCCA	CACCTGGTACTGCTCCTGCTCCCCAGGGACC
AGCCGCGTCCCTGTCCCTGC	GACCCAGCCGCGTCCCTGTCCCTGCTGGCCC
GTCCCTGTCCCTGCTGGCCC	GCCGCGTCCCTGTCCCTGCTGGCCCCGGCTC
TCGCTCAGAATCAGCTCGAC	CACCATCGCTCAGAATCAGCTCGACCGGCGC
CTCGACCGGCGCGCTGTCCC	ATCAGCTCGACCGGCGCGCTGTCCCCGGACC
TGTCCCCGGACCAGCCGTTT	CGCGCTGTCCCCGGACCAGCCGTTTTGGTTG
CGTTTTGGTTGTCATGCAGC	CCAGCCGTTTTGGTTGTCATGCAGCCGGTAG
GGTTGTCATGCAGCCGGTAG	GTTTTGGTTGTCATGCAGCCGGTAGCGGCAG
GTCATGCAGCCGGTAGCGGC	TGGTTGTCATGCAGCCGGTAGCGGCAGGTGT
TGTAGTGACCTCCATCCCCC	GCAGGTGTAGTGACCTCCATCCCCCAGGGCC
GTAGTGACCTCCATCCCCCA	CAGGTGTAGTGACCTCCATCCCCCAGGGCCA
CCCCCAGGGCCACCGCGTTC	TCCATCCCCCAGGGCCACCGCGTTCAGGTGA
AGGTGAAAGAAGATGCGATC	CGTTCAGGTGAAAGAAGATGCGATCTGGGCT
GGTGAAAGAAGATGCGATCT	GTTCAGGTGAAAGAAGATGCGATCTGGGCTG
AAAGAAGATGCGATCTGGGC	AGGTGAAAGAAGATGCGATCTGGGCTGGTGC
ATCTGGGCTGGTGCTGCTCC	ATGCGATCTGGGCTGGTGCTGCTCCTGGGTA
TCTGGGCTGGTGCTGCTCCT	TGCGATCTGGGCTGGTGCTGCTCCTGGGTAC
CTTTCTCCCCGCGCCGTAGC	CAGCTCTTTCTCCCCGCGCCGTAGCTGGAAG
GCTGGAAGTCCACTCCACTC	CCGTAGCTGGAAGTCCACTCCACTCAGGGGA
CTGGAAGTCCACTCCACTCA	CGTAGCTGGAAGTCCACTCCACTCAGGGGAG
TGGAAGTCCACTCCACTCAG	GTAGCTGGAAGTCCACTCCACTCAGGGGAGC
TCCACTCAGGGGAGCCACGC	TCCACTCCACTCAGGGGAGCCACGCAGGTGA
TCAGGGGAGCCACGCAGGTG	TCCACTCAGGGGAGCCACGCAGGTGAGGGTC
CAGGGGAGCCACGCAGGTGA	CCACTCAGGGGAGCCACGCAGGTGAGGGTCA
GTGAGGGTCACCTTGTTGCC	CGCAGGTGAGGGTCACCTTGTTGCCAGGGTG
TGAGGGTCACCTTGTTGCCA	GCAGGTGAGGGTCACCTTGTTGCCAGGGTGC
TCACCTTGTTGCCAGGGTGC	GAGGGTCACCTTGTTGCCAGGGTGCAGGACC
TGTTGCCAGGGTGCAGGACC	CACCTTGTTGCCAGGGTGCAGGACCTGGGAG
GTTGCCAGGGTGCAGGACCT	ACCTTGTTGCCAGGGTGCAGGACCTGGGAGG
GCCAGGGTGCAGGACCTGGG	TTGTTGCCAGGGTGCAGGACCTGGGAGGACT
GGACCTGGGAGGACTCTCCA	GTGCAGGACCTGGGAGGACTCTCCATGGTGC
TCTCCATGGTGCATCAGCAC	AGGACTCTCCATGGTGCATCAGCACAGGCGG
CCATGGTGCATCAGCACAGG	ACTCTCCATGGTGCATCAGCACAGGCGGTGG
TGGTGCATCAGCACAGGCGG	CTCCATGGTGCATCAGCACAGGCGGTGGTGG
TGCATCAGCACAGGCGGTGG	CATGGTGCATCAGCACAGGCGGTGGTGGTGC
TGGTGGTGCAGCTGCAATGC	GGCGGTGGTGGTGCAGCTGCAATGCAGGCAG
GCAATGCAGGCAGCATTACT	CAGCTGCAATGCAGGCAGCATTACTAGGCTG
TTACTAGGCTGCCCCATCCC	CAGCATTACTAGGCTGCCCCATCCCTGGAGC
GTCCCCAGACCTCTGCCCTC	GCCCAGTCCCCAGACCTCTGCCCTCCGGGTG
TCCCCAGACCTCTGCCCTCC	CCCAGTCCCCAGACCTCTGCCCTCCGGGTGG
CCAGACCTCTGCCCTCCGGG	AGTCCCCAGACCTCTGCCCTCCGGGTGGCAA
GCCCTCCGGGTGGCAATCCC	CCTCTGCCCTCCGGGTGGCAATCCCAGGAAC
TTTTTTTTTTTTTTTTGAAA	TTCTTTTTTTTTTTTTTTTTTGAAACGGAGT
GAGTTTCGCTCTTGTTGCCC	AAACGGAGTTTCGCTCTTGTTGCCCAGGCTG
TTCGCTCTTGTTGCCCAGGC	GGAGTTTCGCTCTTGTTGCCCAGGCTGGAGT
TTGCCCAGGCTGGAGTGCAG	TCTTGTTGCCCAGGCTGGAGTGCAGTGGCGC
CACTGCAAGCTCTGCCTCCC	CAGCTCACTGCAAGCTCTGCCTCCCAGGTTC
AGCTCTGCCTCCCAGGTTCA	CTGCAAGCTCTGCCTCCCAGGTTCAAGGGAT
GCTCTGCCTCCCAGGTTCAA	TGCAAGCTCTGCCTCCCAGGTTCAAGGGATT
GCCTCAGCCTCCTGAGTAGC	CTCCTGCCTCAGCCTCCTGAGTAGCTGGTAC
TCCTGAGTAGCTGGTACTAC	CAGCCTCCTGAGTAGCTGGTACTACAGGCAC
CAGGCACCTGCCACCACACC	TACTACAGGCACCTGCCACCACACCTGGCTA
TTTTGTATTTTTAGTAGAGA	CTAATTTTTGTATTTTTAGTAGAGACGGGGT
TTTGTATTTTTAGTAGAGAC	TAATTTTTGTATTTTTAGTAGAGACGGGGTT
TTGTATTTTTAGTAGAGACG	AATTTTTGTATTTTTAGTAGAGACGGGGTTT
GAGACGGGGTTTCGTCATGT	TAGTAGAGACGGGGTTTCGTCATGTTGGGTA
AGACGGGGTTTCGTCATGTT	AGTAGAGACGGGGTTTCGTCATGTTGGGTAG
TTTCGTCATGTTGGGTAGAC	CGGGGTTTCGTCATGTTGGGTAGACTGGTCT
CTCTTGACCTCATGATCCGC	TCGATCTCTTGACCTCATGATCCGCTGGCCT
GCCTCAGCCTCCCAAAGTGC	CGCTGGCCTCAGCCTCCCAAAGTGCTGGGAT
CCTCAGCCTCCCAAAGTGCT	GCTGGCCTCAGCCTCCCAAAGTGCTGGGATT
TCCCAAAGTGCTGGGATTAT	CAGCCTCCCAAAGTGCTGGGATTATAGGCGT
TAGGCGTGAGCCACCGCACC	GATTATAGGCGTGAGCCACCGCACCCGGCCT
GGCCTCACCCTTCCATTCTT	CACCCGGCCTCACCCTTCCATTCTTTGGGCA
GCCTCACCCTTCCATTCTTT	ACCCGGCCTCACCCTTCCATTCTTTGGGCAT
CCTTTGCAACCATCAGACCC	AAACTCCTTTGCAACCATCAGACCCAGGCAA
ATCAGACCCAGGCAACCGTG	CAACCATCAGACCCAGGCAACCGTGTGGCCA
CAACCGTGTGGCCAGCTTCC	CCAGGCAACCGTGTGGCCAGCTTCCTGGACC
TGTGGCCAGCTTCCTGGACC	AACCGTGTGGCCAGCTTCCTGGACCTGGTCC
CAGCTTCCTGGACCTGGTCC	GTGGCCAGCTTCCTGGACCTGGTCCTGGGCA
AGCTTCCTGGACCTGGTCCT	TGGCCAGCTTCCTGGACCTGGTCCTGGGCAA
CCTGGACCTGGTCCTGGGCA	AGCTTCCTGGACCTGGTCCTGGGCAAGGACA
CTGGGCAAGGACATTCAGCA	TGGTCCTGGGCAAGGACATTCAGCATGGAGG
GGCAAGGACATTCAGCATGG	TCCTGGGCAAGGACATTCAGCATGGAGGTCA
GGACATTCAGCATGGAGGTC	GGCAAGGACATTCAGCATGGAGGTCAGGATG
CATGGAGGTCAGGATGAATG	TTCAGCATGGAGGTCAGGATGAATGTGGTCA
CCCCCAGCAGCCCCCAGAGA	CTCCTCCCCCAGCAGCCCCCAGAGATGGTTC
ACAGTCACCGAGCTCCTCAA	TTCCCACAGTCACCGAGCTCCTCAATGGTCA
CTCAATGGTCACAGTAGCGC	AGCTCCTCAATGGTCACAGTAGCGCTGGGCT
TCAATGGTCACAGTAGCGCT	GCTCCTCAATGGTCACAGTAGCGCTGGGCTC
CAGTAGCGCTGGGCTCAGAG	GGTCACAGTAGCGCTGGGCTCAGAGAGGGCG
AGTAGCGCTGGGCTCAGAGA	GTCACAGTAGCGCTGGGCTCAGAGAGGGCGC
AGAGAGGGCGCCTTCCCCAT	GGCTCAGAGAGGGCGCCTTCCCCATCGGTCC
GGGCGCCTTCCCCATCGGTC	AGAGAGGGCGCCTTCCCCATCGGTCCGGTAG
TAGCTGCAGCTGTAGTTGCC	TCCGGTAGCTGCAGCTGTAGTTGCCAGGCTG
AGCTGTAGTTGCCAGGCTGA	GCTGCAGCTGTAGTTGCCAGGCTGATGGACT
TAGTTGCCAGGCTGATGGAC	AGCTGTAGTTGCCAGGCTGATGGACTGGAAA
GCCAGGCTGATGGACTGGAA	TAGTTGCCAGGCTGATGGACTGGAAAGGTGG
AGGCTGATGGACTGGAAAGG	TTGCCAGGCTGATGGACTGGAAAGGTGGCCT
AGGTGGCCTCCACATCCTCC	TGGAAAGGTGGCCTCCACATCCTCCTGGGCC
GGTGGCCTCCACATCCTCCT	GGAAAGGTGGCCTCCACATCCTCCTGGGCCT
TCCACATCCTCCTGGGCCTC	TGGCCTCCACATCCTCCTGGGCCTCAGGCAC
CAGGCACCTCCAGAAACTCA	GGCCTCAGGCACCTCCAGAAACTCATGGTCG
TCACACCCCGCAGCACACCT	AAAAGTCACACCCCGCAGCACACCTCGGCAC
GGCACACTGCTGTTGTTTTC	ACCTCGGCACACTGCTGTTGTTTTCAGGCCG
CACTGCTGTTGTTTTCAGGC	CGGCACACTGCTGTTGTTTTCAGGCCGGGGG
ACTGCTGTTGTTTTCAGGCC	GGCACACTGCTGTTGTTTTCAGGCCGGGGGT
CTGCTGTTGTTTTCAGGCCG	GCACACTGCTGTTGTTTTCAGGCCGGGGGTG
TGCTGTTGTTTTCAGGCCGG	CACACTGCTGTTGTTTTCAGGCCGGGGGTGA
TTTCAGGCCGGGGGTGATCC	GTTGTTTTCAGGCCGGGGGTGATCCAGGACA
CCGGGGGTGATCCAGGACAC	TCAGGCCGGGGGTGATCCAGGACACTGGCGC
CACTGGCGCCATCGAGAGCC	CAGGACACTGGCGCCATCGAGAGCCAGGGAG
ACTGGCGCCATCGAGAGCCA	AGGACACTGGCGCCATCGAGAGCCAGGGAGC
GCCATCGAGAGCCAGGGAGC	CTGGCGCCATCGAGAGCCAGGGAGCAGGCAA
CGAGAGCCAGGGAGCAGGCA	GCCATCGAGAGCCAGGGAGCAGGCAAGGACT
GGGAGCAGGCAAGGACTCTG	AGCCAGGGAGCAGGCAAGGACTCTGTGGGTG
GGAGCAGGCAAGGACTCTGT	GCCAGGGAGCAGGCAAGGACTCTGTGGGTGG
GCAGGCAAGGACTCTGTGGG	AGGGAGCAGGCAAGGACTCTGTGGGTGGGGT
CAGGCAAGGACTCTGTGGGT	GGGAGCAGGCAAGGACTCTGTGGGTGGGGTG
AGGCAAGGACTCTGTGGGTG	GGAGCAGGCAAGGACTCTGTGGGTGGGGTGG
CAAGGACTCTGTGGGTGGGG	GCAGGCAAGGACTCTGTGGGTGGGGTGGAGT
GAAGAGTGCTTCTGCATAAC	GAGTTGAAGAGTGCTTCTGCATAACAGGAGA
CTTCTGCATAACAGGAGACG	GAGTGCTTCTGCATAACAGGAGACGTGGGAA
TTCTGCATAACAGGAGACGT	AGTGCTTCTGCATAACAGGAGACGTGGGAAG
GTGGGAAGCCCAGCAGAACC	GAGACGTGGGAAGCCCAGCAGAACCTGGGCC
TGGGAAGCCCAGCAGAACCT	AGACGTGGGAAGCCCAGCAGAACCTGGGCCC
CCACACTCATAAGACTGTGA	GGGCCCCACACTCATAAGACTGTGAAGGAGA
CATAAGACTGTGAAGGAGAC	ACACTCATAAGACTGTGAAGGAGACAGGGAT
ATAAGACTGTGAAGGAGACA	CACTCATAAGACTGTGAAGGAGACAGGGATG
GACTGTGAAGGAGACAGGGA	CATAAGACTGTGAAGGAGACAGGGATGGAGG
TGTGAAGGAGACAGGGATGG	AAGACTGTGAAGGAGACAGGGATGGAGGGCA
GTGAAGGAGACAGGGATGGA	AGACTGTGAAGGAGACAGGGATGGAGGGCAT
ACAGGGATGGAGGGCATTGC	AGGAGACAGGGATGGAGGGCATTGCTGGGAA
CAGGGATGGAGGGCATTGCT	GGAGACAGGGATGGAGGGCATTGCTGGGAAA
TGGAGGGCATTGCTGGGAAA	AGGGATGGAGGGCATTGCTGGGAAAAGGCAG
GGGCATTGCTGGGAAAAGGC	ATGGAGGGCATTGCTGGGAAAAGGCAGGCAG
ATTGCTGGGAAAAGGCAGGC	AGGGCATTGCTGGGAAAAGGCAGGCAGGCAC
AAAAGGCAGGCAGGCACCAG	CTGGGAAAAGGCAGGCAGGCACCAGTGGAAA
GGCAGGCACCAGTGGAAACA	AGGCAGGCAGGCACCAGTGGAAACAAGGCAT
ACCAGTGGAAACAAGGCATA	CAGGCACCAGTGGAAACAAGGCATACGGCAA
GGCAAGAGAAAAAGAGTGTG	CATACGGCAAGAGAAAAAGAGTGTGTGGGAG
GCAAGAGAAAAAGAGTGTGT	ATACGGCAAGAGAAAAAGAGTGTGTGGGAGC
AAGAGTGTGTGGGAGCTGTA	AGAAAAAGAGTGTGTGGGAGCTGTACGGCAT
GTGGGAGCTGTACGGCATGC	AGTGTGTGGGAGCTGTACGGCATGCCGGGCC
TGGGAGCTGTACGGCATGCC	GTGTGTGGGAGCTGTACGGCATGCCGGGCCT
GTACGGCATGCCGGGCCTGC	GAGCTGTACGGCATGCCGGGCCTGCTGGGGA
TACGGCATGCCGGGCCTGCT	AGCTGTACGGCATGCCGGGCCTGCTGGGGAC
ACGGCATGCCGGGCCTGCTG	GCTGTACGGCATGCCGGGCCTGCTGGGGACA
CATCATCCCCATTTGACAGA	ACAGACATCATCCCCATTTGACAGATGGGAA
ATCATCCCCATTTGACAGAT	CAGACATCATCCCCATTTGACAGATGGGAAG
CATTTGACAGATGGGAAGAT	ATCCCCATTTGACAGATGGGAAGATTGGGGC
ATTTGACAGATGGGAAGATT	TCCCCATTTGACAGATGGGAAGATTGGGGCT
TTTGACAGATGGGAAGATTG	CCCCATTTGACAGATGGGAAGATTGGGGCTT
CAGATGGGAAGATTGGGGCT	TTTGACAGATGGGAAGATTGGGGCTTGGGGC
AGATGGGAAGATTGGGGCTT	TTGACAGATGGGAAGATTGGGGCTTGGGGCT
GATGGGAAGATTGGGGCTTG	TGACAGATGGGAAGATTGGGGCTTGGGGCTC
GGCTTGGGGCTCAGAGACAT	ATTGGGGCTTGGGGCTCAGAGACATCGGGTG
GCTTGGGGCTCAGAGACATC	TTGGGGCTTGGGGCTCAGAGACATCGGGTGA
CTCAGAGACATCGGGTGACT	TGGGGCTCAGAGACATCGGGTGACTTGGAGG
AGAGACATCGGGTGACTTGG	GGCTCAGAGACATCGGGTGACTTGGAGGAAG
ACATCGGGTGACTTGGAGGA	CAGAGACATCGGGTGACTTGGAGGAAGGGAG
CATCGGGTGACTTGGAGGAA	AGAGACATCGGGTGACTTGGAGGAAGGGAGA
ACAACCTACCCACTGCCTCC	AGTCAACAACCTACCCACTGCCTCCTGGCCC
CTGGCCCCCAATTCATGCCC	GCCTCCTGGCCCCCAATTCATGCCCCGGCTC
AATTCATGCCCCGGCTCACT	CCCCCAATTCATGCCCCGGCTCACTTGGCCC
CACTTGGCCCTGTCAGCTCC	CGGCTCACTTGGCCCTGTCAGCTCCAGGAGC
GCTCCAGGAGCTTGCTCAGC	TGTCAGCTCCAGGAGCTTGCTCAGCTGGGTC
CTCCAGGAGCTTGCTCAGCT	GTCAGCTCCAGGAGCTTGCTCAGCTGGGTCC
GCTCAGCTGGGTCCATCCTG	AGCTTGCTCAGCTGGGTCCATCCTGTGGACA
ATCCTGTGGACAAGCCCGAG	GGTCCATCCTGTGGACAAGCCCGAGCGGCAG
TGGACAAGCCCGAGCGGCAG	TCCTGTGGACAAGCCCGAGCGGCAGCGGTAG
AGCCCGAGCGGCAGCGGTAG	GGACAAGCCCGAGCGGCAGCGGTAGCGGCCC
AGCGGCAGCGGTAGCGGCCC	GCCCGAGCGGCAGCGGTAGCGGCCCTGGGTG
GCGGCAGCGGTAGCGGCCCT	CCCGAGCGGCAGCGGTAGCGGCCCTGGGTGT
CCTGGGTGTCACCCGTCAGC	GCGGCCCTGGGTGTCACCCGTCAGCAGGAAC
TGTCACCCGTCAGCAGGAAC	CTGGGTGTCACCCGTCAGCAGGAACTGGTGC
CAGCAGGAACTGGTGCTTGA	CCCGTCAGCAGGAACTGGTGCTTGATGGCAG
AGGAACTGGTGCTTGATGGC	TCAGCAGGAACTGGTGCTTGATGGCAGGTGA
GCTTGATGGCAGGTGAGTCA	CTGGTGCTTGATGGCAGGTGAGTCAAGGTGC
GCAGGTGAGTCAAGGTGCAC	TGATGGCAGGTGAGTCAAGGTGCACAGGCTC
AGTCAAGGTGCACAGGCTCC	AGGTGAGTCAAGGTGCACAGGCTCCTGGGCC
GTCAAGGTGCACAGGCTCCT	GGTGAGTCAAGGTGCACAGGCTCCTGGGCCA
CCACCCCATTCTTGAACAGC	CTGGGCCACCCCATTCTTGAACAGCTGGAAG
TTCTTGAACAGCTGGAAGTC	CCCCATTCTTGAACAGCTGGAAGTCTGGAGT
GCTGGAAGTCTGGAGTCTCC	GAACAGCTGGAAGTCTGGAGTCTCCAGGTGG
GGAAGTCTGGAGTCTCCAGG	CAGCTGGAAGTCTGGAGTCTCCAGGTGGGCC
GAAGTCTGGAGTCTCCAGGT	AGCTGGAAGTCTGGAGTCTCCAGGTGGGCCT
CTGGAGTCTCCAGGTGGGCC	GAAGTCTGGAGTCTCCAGGTGGGCCTGGCAC
CTGGCACGTCAGCGTCACAT	TGGGCCTGGCACGTCAGCGTCACATTGGCCA
CGTCAGCGTCACATTGGCCA	TGGCACGTCAGCGTCACATTGGCCAAGGGTT
GTCAGCGTCACATTGGCCAA	GGCACGTCAGCGTCACATTGGCCAAGGGTTT
CAAGGGTTTCAGCAGTGATT	TTGGCCAAGGGTTTCAGCAGTGATTCGGACT
GTGATTCGGACTCTGCCCAC	CAGCAGTGATTCGGACTCTGCCCACAGGCTG
TTCGGACTCTGCCCACAGGC	AGTGATTCGGACTCTGCCCACAGGCTGGGCT
TCGGACTCTGCCCACAGGCT	GTGATTCGGACTCTGCCCACAGGCTGGGCTG
GCTGCGTCTCATAAACTGCA	GCTGGGCTGCGTCTCATAAACTGCAAGGGGT
CTGCGTCTCATAAACTGCAA	CTGGGCTGCGTCTCATAAACTGCAAGGGGTG
TGCGTCTCATAAACTGCAAG	TGGGCTGCGTCTCATAAACTGCAAGGGGTGG
GTCTCATAAACTGCAAGGGG	GCTGCGTCTCATAAACTGCAAGGGGTGGCTG
CATAAACTGCAAGGGGTGGC	CGTCTCATAAACTGCAAGGGGTGGCTGGGAT
ATAAACTGCAAGGGGTGGCT	GTCTCATAAACTGCAAGGGGTGGCTGGGATC
CAGCTCAGTGCCACAGAGAC	GGGATCAGCTCAGTGCCACAGAGACAGGGCT
AGCTCAGTGCCACAGAGACA	GGATCAGCTCAGTGCCACAGAGACAGGGCTC
ACAGAGACAGGGCTCCCCCC	GTGCCACAGAGACAGGGCTCCCCCCCGGCCT
GACAGGGCTCCCCCCCGGCC	ACAGAGACAGGGCTCCCCCCCGGCCTGGGCC
ACAGGGCTCCCCCCCGGCCT	CAGAGACAGGGCTCCCCCCCGGCCTGGGCCC
CTCACCCCTGCACTCACATA	CAGACCTCACCCCTGCACTCACATATGGCTG
CATATGGCTGCTTCTGTCAC	ACTCACATATGGCTGCTTCTGTCACTGGGCC
ATATGGCTGCTTCTGTCACT	CTCACATATGGCTGCTTCTGTCACTGGGCCC
TGCTTCTGTCACTGGGCCCC	ATGGCTGCTTCTGTCACTGGGCCCCAGGTGA
TGGGCCCCAGGTGACACCTG	GTCACTGGGCCCCAGGTGACACCTGCGGAGA
CTGCGGAGACAGCCCCCGTA	GACACCTGCGGAGACAGCCCCCGTAAGGCTC
TTCCCGCCCCCTCCCGCCCC	TCCTGTTCCCGCCCCCTCCCGCCCCAGGGAC
TCCCGCCCCCTCCCGCCCCA	CCTGTTCCCGCCCCCTCCCGCCCCAGGGACC
GCCCCAGGGACCCAGACCCC	CTCCCGCCCCAGGGACCCAGACCCCAGGAGG
CCAGGGACCCAGACCCCAGG	CCGCCCCAGGGACCCAGACCCCAGGAGGCCT
CAAGAGAAAGACCACGAGCA	CACAGCAAGAGAAAGACCACGAGCATGGACA
GACCACGAGCATGGACATGA	AGAAAGACCACGAGCATGGACATGATGGTCG
CATGATGGTCGCGCTCACTC	ATGGACATGATGGTCGCGCTCACTCCGGTGC
ACTCCGGTGCAGTGAGTGTC	CGCTCACTCCGGTGCAGTGAGTGTCTGGGGT
CTCCGGTGCAGTGAGTGTCT	GCTCACTCCGGTGCAGTGAGTGTCTGGGGTG
TCCGGTGCAGTGAGTGTCTG	CTCACTCCGGTGCAGTGAGTGTCTGGGGTGA
GGTGAGCGTCTGCAGCAATG	TCTGGGGTGAGCGTCTGCAGCAATGAGGCCC
